--- 
? !ruby/symbol en
: 
  АБАЙ: " ABAY "
  АБАКАН: " Abakan "
  АБАН: " Abani "
  АБДУЛИНО: " Abdulino "
  АБИНСК: " Abinsk "
  АБОВЯН: " Abovyan "
  АВДЕЕВКА: " Avdeevka "
  АГАПОВКА: " Agapovka "
  АГДАМ: " AGDAM "
  АГИНСКОЕ: " Aginskiy "
  АГРЫЗ: " Agryz "
  АДАМОВКА: " Adamovka "
  АДЛЕР: " ADLER "
  АЗИЗБЕКОВ: " Azizbekov "
  АЗНАКАЕВО: " Aznakaevo "
  АЗОВ: " Carpathian "
  АЙКИНО: " AYKINO "
  АКАЛТЫН: " Akaltin "
  АКЖАР: " Akzhar "
  АКИМОВКА: " Akimovka "
  АККОЛЬ: " Accola "
  АККУРГАН: " Akkurgan "
  АКМАНГИТ: " Akmangit "
  АКСАЙ: " AXA"
  АКСУБАЕВО: "AKSUBAEVO "
  АКТАНЫШ: " AKTANYSH "
  АКТАШ: " Aktaş "
  АКТЮБИНСК: " AKTOBE "
  АКША: " Akshay "
  АЛАБУКА: " Alabuka "
  АЛАВЕРДЫ: " Alaverdi "
  АЛАГИР: " Alagir "
  АЛАПАЕВСК: " ALAPAEVSKIE "
  АЛАТ: " GOT "
  АЛАТЫРЬ: " Sura "
  АЛГА: " ALGA "
  АЛДАН: " ALDAN "
  АЛЕЙСК: " Aleisk "
  АЛЕКСАНДР-НЕВСК: " Alexander Nevsky "
  АЛЕКСАНДРИЯ: " Alexander "
  АЛЕКСАНДРОВ: " Alexander "
  ? "АЛЕКСАНДРОВ ГАЙ"
  : " Alexander GUY "
  АЛЕКСАНДРОВКА: " Aleksandrovka "
  АЛЕКСАНДРОВСК: " ALEXANDER "
  АЛЕКСАНДРОВСКОЕ: " ALEXANDER "
  АЛЕКСЕВКА: " ALEKSEVKA "
  АЛЕКСЕЕВКА: " Alekseevka "
  АЛЕКСЕЕВСКОЕ: " ALEXEEVSKY "
  АЛЕКСИН: " Aleksino"
  АЛИ-БАЙРАМЛЫ: "Alibayramli "
  АЛИКОВО: " Alikovo "
  АЛИТУС: " Alytus "
  АЛМА-АТА: " ALMA-ATA "
  АЛМАЛЫК: " ALMALIK "
  АЛНАШИ: " Alnashi "
  АЛТАЙСКИЙ: " ALTAI "
  АЛТЫАРЫК: " Altiarik "
  АЛТЫНКУЛЬ: " Altinkul "
  АЛУКСНЕ: " ALUKSNE "
  АЛУШТА: " Alushta "
  АЛЬМЕНЕВО: " ALMENEVO "
  АЛЬМЕТЬЕВСК: " Almetjevsk "
  АМВРОСИЕВКА: " Amvrosiyivka "
  АМГА: " Amga "
  АМУРСК: " AMURSKAYA "
  АНАНЬЕВ: " ANANIEV "
  АНАПА: " Anapa "
  АНГАРСК: " ANGARSK "
  АНГОР: " ANGORA "
  АНГРЕН: " POLICIES "
  АНДИЖАН: " Andijan "
  АНДРЕАПОЛЬ: " Andreapol "
  АНДРИАНОВО: " ANDRIANOVA "
  АНДРОНОВСКОЕ: " Andronovo"
  АНДРУШЕВКА: "Andrushevka "
  АНЖЕРО-СУДЖЕНСК: " Angers-Sudzhensk "
  АНИВА: " ANIVA "
  АНИКЩЯЙ: " Anykščiai "
  АНИНО: " Anya "
  АННА: " ANNA "
  АННАУ: " ANNA "
  АНРЕЕВКА: " ANREEVKA "
  АНТРАЦИТ: " ANTHRACENE "
  АНТРОПОВО: " Antropov "
  АНУЧИНО: " Anuchina "
  АПАРАН: " Aparan "
  АПАСТОВО: " APASTOVO "
  АПАТИТЫ: " Apatity "
  АПОСТОЛОВО: " Apostolove "
  АПШЕРОНСК: " ABSHERON "
  АРАВАН: " Aravan "
  АРБУЗИНКА: " Arbuzinka "
  АРГАЯШ: " Argayash "
  АРГУН: " Argun "
  АРДАТОВ: " Ardatov "
  АРДОН: " ARDON "
  АРЗАМАС: " Arzamas "
  АРКАДАК: " Arkadak "
  АРКАЛЫК: " Arkalyk"
  АРМАВИР: "ARMAVIR "
  АРСЕНЬЕВ: " ARSENOV "
  АРСЕНЬЕВО: " Arsen&#39;eva "
  АРСК: " ARSK "
  АРТАШАТ: " Artashat "
  АРТЕМ: " Artem "
  АРТЕМОВСК: " ARTYOMOVSK "
  АРТЕМОВСКИЙ: " ARTYOMOVSK "
  АРТИ: " ARTI "
  АРТИК: " Artik "
  АРХАНГЕЛЬСК: " Arkhangelsk "
  АРХАНГЕЛЬСКОЕ: " Arkhangelsk "
  АРХОНКА: " ARHONKA "
  АРЦИЗ: " Artsiz "
  АРЫКБАЛЫК: " ARYKBALYK "
  АСБЕСТ: " ASBESTOS "
  АСИНО: " Asino "
  АСКАРОВО: " Askarova "
  АСКИНО: " Askin "
  АССА: " ACCA "
  АСТАРА: " ASTARA "
  АСТРАХАНКА: " Astrakhanka "
  АСТРАХАНЬ: " Astrakhan "
  АТБАСАР: " Atbasar "
  АТБАШИ: " Atbash"
  АТКАРСК: "Atkarsk "
  АТЮРЬЕВО: " ATYUREVO "
  АТЯШЕВО: " ATYASHEVO "
  АХАЛКАЛАКИ: " Akhalkalaki "
  АХАНГАРАН: " Ahangaran "
  АХМЕТА: " Ahmet "
  АХСУ: " Achsah "
  АХТУБИНСК: " Akhtubinsk "
  АХТЫРКА: " Okhtirka "
  АХУНБАБАЕВ: " Akhunbabaev "
  АЧИНСК: " ACHINSK "
  АЧХОЙ-МАРТАН: " Achkhoi-Martan "
  АШТАРАК: " ASHTARAK "
  АШХАБАД: " Ashgabat "
  АЯГУЗ: " Ayaguz "
  Б-БЕРЕЗНИКИ: " B-Berezniki "
  Б-ВЛАДИМИРОВКА: " B-Vladimirovka "
  Б-ГЛУШИЦА: " B-Głuszyca "
  Б-ИГНАТОВО: " B-Ignatova "
  Б-ИЖОРА: " B - IZHORA "
  Б-КОЛПАНЫ: " B-КОЛПАНЫ "
  Б-МАРТЫНОВКА: " B-Martynovka "
  Б-НАГАТКИНО: " B-NAGATKINO "
  Б-СОЛДАТСКОЕ: " B-SOLDIERS "
  Б-СОРОКИНО: " B-SOROKIN"
  Б-СОСНОВКА: "B-Sosnovka "
  Б-ЧЕРНИГОВКА: " B-Chernigovka "
  БАБАЕВО: " BABAYEVA "
  БАБУШКИНО: " GRANDMOTHER "
  БАБЫЛИНО: " BABYLINO "
  БАВЛЫ: " Bavli "
  БАГАЕВСКОЕ: " Bagaevskaya "
  БАГАН: " Bagan "
  БАГАТ: " Bagat "
  БАГДАД: " BAGHDAD "
  БАГРАТИОНОВСК: " Bagrationovsk "
  БАЕВО: " Baev "
  БАЗ-КАРБУЛАК: " BAZ KARBULAK "
  БАЗАР-КОРГОН: " Bazar-Korgon "
  ? "БАЗАРНЫЕ МАТАКИ"
  : " BAZARNAYA Mataka "
  БАЙКАДАМ: " Baikadam "
  БАЙРАМ-АЛИ: " Bairam-Ali "
  БАЙСУН: " BAYSUN "
  БАКАЛЫ: " Bacale "
  БАКАНАС: " Bakanas "
  БАКСАН: " Baksan "
  БАКУ: " Baku "
  БАЛАБАНОВО: " Balabanova "
  БАЛАКЛЕЯ: " Balakliya "
  БАЛАКОВО: " Balakovo"
  БАЛАХНА: "Balakhna "
  БАЛАХТА: " BALAHTA "
  БАЛАШОВ: " Balashov "
  БАЛВИ: " Balvi "
  БАЛЕВИНО: " BALEVINO "
  БАЛЕЗИНО: " Balezino "
  БАЛЕЙ: " Bailey "
  БАЛКАШИНО: " Balkashinov "
  БАЛТА: " BALT "
  БАЛТАЙ: " Baltaev "
  БАЛТАСИ: " Baltasi "
  БАЛТИЙСК: " BALTIISK "
  БАЛХАШ: " BALKHASH "
  БАЛЫКЧИ: " Balykchi "
  БАРАБИНСК: " Barabinsk "
  БАРАНОВИЧИ: " Gomel "
  БАРАНОВКА: " Baranovka "
  БАРВЕНКОВО: " Barvinkove "
  БАРГУЗИН: " BARGUZIN "
  БАРДА: " BARDA "
  БАРНАУЛ: " Barnaul "
  БАРШАТАС: " BARSHATAS "
  БАРЫШ: " BARYSHEV "
  БАРЫШЕВКА: " Barishivka "
  БАРЯТИНО: " BARYATINO"
  БАТАЙСК: "Bataisk "
  БАТАМШИНСКИЙ: " BATAMSHINSKY "
  БАТЕЦКИЙ: " Batetskaya "
  БАТОВО: " BATOVA "
  БАТУМИ: " Batumi "
  БАТЫРЕВО: " Batyrevo "
  БАУСКА: " BAUSKAS "
  БАХАРДЕН: " Baharden "
  БАХМАЧ: " Bahmach "
  БАХЧИСАРАЙ: " BAHCHISARAY "
  БАШМАКОВО: " Bashmakova "
  БАШТАНКА: " Bashtanka "
  БЕДНОДЕМЯНСК: " BEDNODEMYANSK "
  БЕЖАНИЦЫ: " BEZHANITSY "
  БЕЖЕЦК: " Bezhetsk "
  БЕЗЕНЧУК: " Bezenchuk "
  БЕЗМЕИН: " Bezmein "
  БЕЙЛАГАН: " BEYLAGAN "
  БЕКАБАД: " Bekabad "
  БЕЛАЯ: " WHITE "
  ? "БЕЛАЯ ГЛИНА"
  : " WHITE CLAY "
  ? "БЕЛАЯ КАЛИТВА"
  : " WHITE Kalitva "
  ? "БЕЛАЯ ХОЛУНИЦА"
  : " WHITE Kholunitsa "
  ? "БЕЛАЯ ЦЕРКОВЬ"
  : " WHITE CHURCH "
  БЕЛГОРОД: " Belgorod"
  БЕЛЕБЕЙ: "Belebej "
  БЕЛЕВ: " Belev "
  БЕЛИНСКИЙ: " BELINSKY "
  БЕЛОВО: " BELOV "
  БЕЛОВОДСК: " Belovodsk "
  БЕЛОГОРСК: " Belogorsk "
  БЕЛОГОРЬЕ: " Belogorie "
  БЕЛОЗЕРКА: " Belozerka "
  БЕЛОЗЕРСК: " BELOZERSK "
  БЕЛОЗЕРСКОЕ: " BELOZERSK "
  БЕЛОКУРАКИНО: " Belokurakino "
  БЕЛОКУРИХА: " Belokurikha "
  БЕЛОМОРСК: " BELOMORSKO "
  БЕЛОПОЛЬЕ: " Belopole "
  БЕЛОРЕЦК: " Beloreck "
  БЕЛОРЕЧЕНСК: " Belorechensk "
  БЕЛОЯРСКИЙ: " Beloyarsk "
  ? "БЕЛЫЕ ВОДЫ"
  : " WHITE WATER "
  БЕЛЫЙ: " White "
  ? "БЕЛЫЙ ЯР"
  : " White DM "
  БЕЛЫНИЧИ: " Bialynichy "
  БЕЛЬЦЫ: " BALTI "
  БЕЛЯЕВКА: " Belyaevka "
  БЕНДЕРЫ: " Bendery "
  БЕРД: " BYRD"
  БЕРДИГЕСТЯХ: "BERDIGESTYAH "
  БЕРДИЧЕВ: " Berdichiv "
  БЕРДСК: " Berdsk "
  БЕРДЮЖЬЕ: " BERDYUZHE "
  БЕРДЯНСК: " Berdyansk "
  БЕРЕГОВО: " ONSHORE "
  БЕРЕЖАНЫЙ: " Berezhany "
  БЕРЕЖКИ: " Berezhki "
  БЕРЕЗА: " BIRCH "
  БЕРЕЗАНКА: " Berezanka "
  БЕРЕЗИНО: " BEREZINA "
  БЕРЕЗНИГОВАТОЕ: " BEREZNIGOVATOE "
  БЕРЕЗНИК: " Bereznik "
  БЕРЕЗНИКИ: " Bereznik "
  БЕРЕЗНО: " Berezno "
  БЕРЕЗОВКА: " Berezovka "
  БЕРЕЗОВО: " BIRCH "
  БЕРЕЗОВСКИЙ: " Berezovsky "
  БЕРЕСТОВИЦА: " Bierastavica "
  БЕРИСЛАВ: " Berislav "
  БЕРУНИ: " BERUNI "
  БЕРШАДЬ: " Bershad "
  БЕСЛАН: " Beslan "
  БЕССАРАБКА: " Besarabka "
  БЕССОНОВКА: " Bessonovka"
  БЕШЕНКОВИЧИ: "Beshenkovichi "
  БЕШКЕНТ: " Beshkent "
  БЕШРАБАТ: " BESHRABAT "
  БИЖБУЛЯК: " BIZHBULYAK "
  БИЙСК: " BIYSK "
  БИЛИБИНО: " Bilibin "
  БИРЖАЙ: " Birzhan "
  БИРОБИДЖАН: " Birobidzhan "
  БИРСК: " Birsk "
  БИРШТОНАС: " Birstonas "
  БИЧУРА: " BICHURA "
  БЛАГОВЕЩЕНКА: " BLAGOVESCHENKA "
  БЛАГОВЕЩЕНСК: " Blagoveshchensk "
  БЛАГОДАРНЫЙ: " Credits "
  БЛИЗНЮКИ: " Bliznyuki "
  БОБРИНЕЦ: " Bobrinets "
  БОБРОВ: " BOBROV "
  БОБРОВИЦА: " Bobrovica "
  БОБРУЙСК: " Bobruisk "
  ? "БОГАТЫЕ САБЫ"
  : " RICH Saba "
  БОГДАНОВИЧ: " BOGDANOVICH "
  БОГДАНОВКА: " Bogdanovka "
  БОГОДУХОВ: " Bogodukhiv "
  БОГОРОДИЦК: " Bogoroditsk "
  БОГОРОДСК: " BOGORODSKAYA"
  БОГОРОДСКОЕ: "BOGORODSKAYA "
  БОГОРОДЧАНЫ: " Bogorodchany "
  БОГУСЛАВ: " BOHUSLAV "
  БОГУЧАР: " Boguchar "
  БОЛГРАД: " Bolgrad "
  БОЛНИСИ: " Bolnisi "
  БОЛОГОЕ: " BOLOGOE "
  БОЛОТНОЕ: " FEN "
  БОЛХОВ: " Bolqu "
  ? "БОЛЬШАЯ МУРТА"
  : " Large URTI "
  БОЛЬШЕНАРЫМСКОЕ: " BOLSHENARYMSKOE "
  БОЛЬШЕРЕЧЬЕ: " Bolsherechye "
  ? "БОЛЬШИЕ УКИ"
  : " LONG USP "
  ? "БОЛЬШОЙ КАМЕНЬ"
  : " BIG STONE "
  ? "БОЛЬШОЙ УЛУЙ"
  : " BIG ULUY "
  БОНДАРИ: " Bondar "
  БОРЗНА: " BORZNA "
  БОРИСЛАВ: " Borislav "
  БОРИСОВ: " Boris "
  ? "БОРИСОВА ГРИВА"
  : " BORISOVA HRIVNAS "
  БОРИСОВКА: " Borisovka "
  БОРИСОГЛЕБСК: " BORISOGLEBSKY "
  БОРИСОГЛЕБСКИЙ: " BORISOGLEBSKY "
  БОРИСПОЛЬ: " BORYSPIL "
  БОРОВАЯ: " БОРОВАЯ"
  БОРОВИЧИ: "Borovich "
  БОРОВОЕ: " БОРОВОЕ "
  БОРОВСК: " BOROVSKY "
  БОРОВСКОЙ: " BOROVSKY "
  БОРОГОНЦЫ: " BOROGONTSY "
  БОРОДИНО: " Borodino "
  БОРОДУЛИХА: " BORODULIHA "
  БОРОДЯНКА: " Borodyanka "
  БОРСКОЕ: " Bor "
  БОРШОВ: " Borsa "
  БРАГИН: " Bragin "
  БРАСЛАВ: " Braslaw "
  БРАТСК: " Bratsk "
  БРАТСКОЕ: " Bratsk "
  БРЕДЫ: " Breda "
  БРЕСТ: " Brest "
  БРИЧАНЫ: " BRICENI "
  БРОВАРЫ: " BROVARY "
  БРОДЫ: " BRODY "
  БРЮХОВЕЦКАЯ: " Silo "
  БРЯНКА: " Bryanka "
  БРЯНСК: " BRYANSK "
  БУГУЛЬМА: " Bugulma "
  БУГУРУСЛАН: " Buguruslan "
  ? "БУДА КОШЕЛЕВО"
  : " BUDA Koshelev"
  БУДЕННОВСК: "Budennovsk "
  БУДОГОШЬ: " BUDOGOSH "
  БУЗДЯК: " Buzdyak "
  БУЗУЛУК: " Busuluk "
  БУИНСК: " Buinsk "
  БУКА: " BEECH "
  БУЛАЕВО: " Bulaevo "
  БУРНОЕ: " BURNO "
  БУРШТЫН: " Burshtyn "
  БУРЫНЬ: " Burin "
  БУСК: " BUSCO "
  БУСТАН: " Bustan "
  БУСТОН: " Buston "
  БУТУРЛИНОВКА: " Buturlinovka "
  БУХАРА: " Bukhara "
  БУЧАЧ: " Buchach "
  БЫКОВО: " BYKOV "
  БЫСТРОВКА: " Bystrovka "
  ? "БЫСТРЫЙ ИСТОК"
  : " Quick Istok "
  БЫХОВ: " Bychaŭ "
  В-АЛЕКСАНДРОВКИ: " In-Aleksandrovka "
  В-БАГАЧКА: " In-Bagachka "
  В-ЛЕПТИХА: " In -LEPTIHA "
  В-МИХАЙЛОВКА: " In-Mikhajlovka "
  В-НОВОСЕЛКА: " In-Novoselka"
  В-РОГАЧИК: "In-Rogachik "
  ВАБКЕНТ: " Vabkent "
  ВАВОЖ: " VAVOZH "
  ВАДИНСК: " VADINSK "
  ВАДУЛ-ЛУЙ-ВОДЭ: " Vadul-lui-Voda "
  ВАЖИНЫ: " Vazhiny "
  ВАЛГА: " VALGA "
  ВАЛДАЙ: " VALDAY "
  ВАЛИХАНОВО: " Valikhanov "
  ВАЛКА: " ROLLS "
  ВАЛКИ: " ROLLS "
  ВАЛМИЕРА: " VALMIERA "
  ВАЛУЙКИ: " Valuiki "
  ВАНИНО: " Busan "
  ВАННОВКА: " VANNOVKA "
  ВАРВА: " Varva "
  ВАРГАШИ: " Vargas "
  ВАРДЕНИС: " VARDENIS "
  ВАРЕНА: " Varena "
  ВАРНА: " Varna "
  ВАРТЕМЯГИ: " VARTEMYAGI "
  ВАСИЛЬЕВКА: " Vasilevka "
  ВАСИЛЬКОВ: " VASILKOV "
  ВАСИЛЬКОВКА: " Vasilkivka "
  ВАХРУШИ: " Vakhrushev"
  ВАХШ: "Vakhsh "
  ВАЧА: " VACHA "
  ВЕДЕНО: " manuf "
  ВЕДЫ: " Veda "
  ВЕЙДЕЛЕВКА: " VEYDELEVKA "
  ВЕКИЛЬ-БАЗАР: " vekil-BAZAAR "
  ВЕЛ-БЕРЕЗНЫЙ: " GBR-Berezniy "
  ВЕЛ-ПИСАРЕВКА: " GBR-Pisarevka "
  ВЕЛИЖ: " Velizh "
  ? "ВЕЛИКИЕ ЛУКИ"
  : " GREAT LUKE "
  ? "ВЕЛИКИЙ БУРЛУК"
  : " THE GREAT Burluk "
  ? "ВЕЛИКИЙ УСТЮГ"
  : " GREAT USTYUG "
  ВЕЛЬСК: " Velsk "
  ВЕНГЕРОВО: " Vengerov "
  ВЕНЕВ: " Venev "
  ВЕНТСПИЛС: " Ventspils "
  ВЕРЕЩАГИНО: " VERESHCHAGIN "
  ВЕРТЕМЯГИ: " VERTEMYAGI "
  ВЕРХ-УСУГЛИ: " TOP-Usugli "
  ВЕРХ-ЧЕБУЛА: " TOP -CHEBULA "
  ВЕРХНЕВИЛЮЙСК: " Verkhnevilyuisk "
  ВЕРХНЕВОЛЫНСКОЕ: " VERHNEVOLYNSKOE "
  ВЕРХНЕДВИНСК: " Vierchniadźvinsk "
  ВЕРХНЕДНЕПРОВСК: " Verkhnodniprovsk "
  ВЕРХНЕУРАЛЬСК: " Verkhneuralsk"
  ВЕРХНЕЯРКЕЕВО: "VERHNEYARKEEVO "
  ? "ВЕРХНИЙ МАМОН"
  : " Top MAMONOV "
  ? "ВЕРХНИЙ УСЛОН"
  : " Top USLON "
  ? "ВЕРХНИЙ УФАЛЕЙ"
  : " Top Ufaley "
  ? "ВЕРХНЯЯ ПЫШМА"
  : " Pishma "
  ВЕРХОВАЖЬЕ: " Verkhovazh&#39;ye "
  ВЕРХОВИНА: " Verhovina "
  ВЕРХОВЬЕ: " Horse "
  ВЕРХОШИЖЕМЬЕ: " VERHOSHIZHEME "
  ВЕСЕЛИНОВО: " Veselinovo "
  ВЕСЕЛОЕ: " MERRY "
  ВЕСЕЛЫЙ: " VESELY "
  ВЕСЬЕГОНСК: " Vesyegonsk "
  ВЕТКА: " BRANCH "
  ВЕШЕНСКАЯ: " Veshenskaya "
  ВЕШКАЙМА: " VESHKAYMA "
  ВЕЩЕВО: " Veshchev "
  ВИЖНИЦА: " Vizhnica "
  ВИЗИНГА: " Vizing "
  ВИКУЛОВО: " Vikulovo "
  ВИЛЕЙКА: " Vialejka "
  ВИЛКАВИШКИС: " Vilkaviskis "
  ВИЛЬНЮС: " VILNIUS "
  ВИЛЬЯНДИ: " VILJANDI "
  ВИЛЮЙСК: " VILUY"
  ВИННИЦА: "VINNYTSIA "
  ВИНОГРАДОВ: " Grape "
  ВИНЬКОВЦЫ: " Vinkivtsi "
  ВИСКА: " Whiskey "
  ВИТЕБСК: " Vitebsk "
  ВИЧУГА: " Vichuga "
  ВИШНЕВКА: " Vishnevka "
  ВЛАДИВОСТОК: " Vladivostok "
  ВЛАДИМИР: " Vladimir "
  ВЛАДИМИР-АЛЕК: " Vladimir-ALEKO "
  ВЛАДИМИР-ВОЛЫНС: " Vladimir-VOLYNS "
  ВЛАДИМИРЕЦ: " Volodimirets "
  ВОЖЕГА: " Vozhega "
  ВОЗВЫШЕНКА: " VOZVYSHENKA "
  ВОЗНЕСЕНСК: " Ascension "
  ВОЗНЕСЕНЬЕ: " Ascension "
  ВОЙСКОВИЦЫ: " VOYSKOVITSY "
  ВОЙСКОРОВО: " VOYSKOROVO "
  ВОЛГОГРАД: " Volgograd "
  ВОЛГОДОНСК: " Volgodonsk "
  ВОЛГОРЕЧЕНСК: " Volgorechensk "
  ВОЛЖСК: " VOLGA "
  ВОЛЖСКИЙ: " VOLGA "
  ВОЛКОВЫСК: " Vaŭkavysk "
  ВОЛНОВАХА: " Volnovaha"
  ВОЛОВО-ЛИПЕЦК: "Ox-LIPETSK "
  ВОЛОВО-ТУЛА: " ox-TULA "
  ВОЛОГДА: " Vologda "
  ВОЛОДАР-ВОЛЫНСК: " Valadar-VOLYNSKOE "
  ВОЛОДАРКА: " Volodarka "
  ВОЛОДАРСКИЙ: " Volodarsk "
  ВОЛОДАРСКОЕ-ДОН: " Volodarsk-DON "
  ВОЛОДАРСКОЕ-КОК: " Volodarsk-CCO "
  ВОЛОЖИН: " VOLOZHIN "
  ВОЛОКАЛАМСК: " Volokalamskoe "
  ВОЛОКОНОВКА: " VOLOKONOVKA "
  ВОЛОСОВО: " Volosovo "
  ВОЛОЧИНСК: " VOLOCHINSK "
  ВОЛУЙКИ: " VOLUYKI "
  ВОЛХОВ: " Volkhov "
  ВОЛЧАНСК: " VOLCHANSK "
  ВОЛЧИХА: " wolf "
  ВОЛЫНСК: " VOLYNSKOE "
  ВОЛЬНО-НАДЕЖДИН: " the Free NADEZHDIN "
  ВОЛЬНЯНСК: " Vilnyansk "
  ВОЛЬСК: " VOLSKI "
  ВОРКУТА: " Vorkuta "
  ВОРОБЬЕВКА: " Vorobiev "
  ВОРОНЕЖ: " Voronezh "
  ВОРОНОВО-ВОЛХОВ: " Voronova-Volkhov"
  ВОРОНОВО-ГРОДНО: "Voronova-Grodno "
  ВОРОТЫНЕЦ: " VOROTYNETS "
  ВОСЕ: " WOCE "
  ВОСКРЕСЕНСК: " VOSKRESENSK "
  ВОТКИНСК: " VOTKINSKY "
  ВРАДНЕВКА: " VRADNEVKA "
  ВСЕВОЛЖСК: " Vsevolzhsk "
  ВУАДИЛЬ: " Vuadil "
  ВУКТЫЛ: " Vuktyl "
  ВУЛКАНЕШТЫ: " Vulcanesti "
  ВУРНАРЫ: " Vurnary "
  ВЫБОРГ: " Vyborg "
  ВЫГОНИЧИ: " VYGONICHI "
  ВЫКСА: " Vyksa "
  ВЫЛЬГОРТ: " Vylgort "
  ВЫРИЦА: " Vyritsa "
  ВЫРУ: " Võru "
  ВЫСЕЛКИ: " Vyselki "
  ВЫСКАТКА: " VYSKATKA "
  ? "ВЫСОКАЯ ГОРА"
  : " HIGH MOUNTAIN "
  ВЫСОКОПОЛЬЕ: " Visokopillya "
  ВЫСОЦК: " VYSOTSKY "
  ВЫТЕГРА: " VYTEGRA "
  ВЫШГОРОД: " Vyshgorod "
  ? "ВЫШНИЙ ВОЛОЧЕК"
  : " Vyshnij Volochek"
  ВЯЗЕМСКИЙ: "Vyazemskij "
  ВЯЗНИКИ: " Vyazniki "
  ВЯЗЬМА: " VYAZMA "
  ? "ВЯТСКИЕ ПОЛЯНЫ"
  : " Vyatskiy fields "
  ГАВРИЛОВ-ПОСАД: " Gavrilov-Posad "
  ГАВРИЛОВ-ЯМ: " Gavrilov-Yam "
  ГАВРИЛОВКА: " Gavrilovka "
  ГАВРИЛОВО: " GAVRILOVA "
  ГАГАРИН-ДЖИЗАК: " GAGARIN-Dihzak "
  ГАГАРИН-СМОЛЕНК: " GAGARIN-Smolenka "
  ГАГРЫ: " GAGRA "
  ГАДЯЧ: " Gadyach "
  ГАЗАКЕНТ: " GAZAKENT "
  ГАЙВОРОН: " Gayvoron "
  ГАЙСИН: " Gaisin "
  ГАЛААСИЯ: " Galaasiya "
  ГАЛИЧ-И-ФРАНКОВ: " Galich-AND-Franco "
  ГАЛИЧ-КОСТРОМА: " Galich-Kostroma "
  ГАЛЯАРАЛ: " GALYAARAL "
  ГАНЦЕВИЧИ: " Gantsevich "
  ГАРГЖДАЙ: " Gargzdai "
  ГАСАН-КУЛИ: " Gasan Kuli "
  ГАТЧИНА: " GATCHINA "
  ГАФУРОВ: " GHAFUR "
  ГВАРДЕЙСК: " GUARDS"
  ГВАРДЕЙСКОЕ: "KUYBYSHIVSKE "
  ГДОВ: " Gdov "
  ГЕЛЕНДЖИК: " Gelendzhik "
  ГЕНИЧЕСК: " Genichesk "
  ГЕОК-ТЕПЕ: " Geok-Tepe "
  ГЕОРГИЕВКА-ДЖАМ: " Georgiyevka-Jam "
  ГЕОРГИЕВКА-СЕМИ: " Georgiyevka-SEVEN "
  ГЕОРГИЕВСК: " GEORGIEV "
  ГЕОРГИЕВСКОЕ: " GEORGIEV "
  ГЕОРГИУ-ДЕЖ: " Gheorghiu-Dej "
  ГЕРГЧАЙ: " GERGCHAY "
  ГИССАР: " Hissar "
  ГЛАБИНЕ: " GLABINE "
  ГЛАЖЕВО: " GLAZHEVO "
  ГЛАЗОВ: " eyes "
  ГЛАЗУНКОВКА: " GLAZUNKOVKA "
  ГЛЕБЫЧЕВО: " GLEBYCHEVO "
  ГЛИНКА: " Glinka "
  ГЛОБИНО: " Globino "
  ГЛОДЯНЫ: " CAHUL "
  ГЛУБОКОЕ: " DEEP "
  ГЛУСК: " Hłusk "
  ГЛУХОВ: " GLUKHOV "
  ГЛУШКОВО: " Glushkov "
  ГЛЫБОКАЯ: " Glybokaya"
  ГЛЯДЯНСКОЕ: "GLYADYANSKOE "
  ГНИВАНЬ: " Gnivan "
  ? "ГОЛАЯ ПРИСТАНЬ"
  : " Chirnivtsi "
  ГОЛИЦЫНО: " GOLITSYN "
  ГОЛОВАНЕВСК: " Golovanevsk "
  ГОЛЫШМАНОВО: " Golyshmanovo "
  ГОМЕЛЬ: " Gomel "
  ГОНЧАРОВО: " GONCHAROVA "
  ГОНЬКОВО: " GONKOVO "
  ГОРБУНКИ: " Gorbunkov "
  ГОРДЕЕВКА: " GORDEEVKA "
  ГОРИ: " GORI "
  ГОРИС: " GORIS "
  ГОРКИ: " SLIDES "
  ГОРЛОВКА: " Gorlovka "
  ГОРНО-АЛТАЙСК: " MINING ALTAISK "
  ГОРНОЗАВОДСК: " Gornozavodsk "
  ГОРНОСТАЕВКА: " Gornostaevka "
  ГОРНЫЙ: " Mining "
  ГОРНЯК: " GORNYAK "
  ГОРОДЕНКА: " GORODENCO "
  ГОРОДЕЦ: " GORODETS "
  ГОРОДИЩЕ: " City "
  ГОРОДНЯ: " GORODNYA "
  ГОРОДОК: " TOWN"
  ГОРОХОВ: "PEAS "
  ГОРШЕЧНОЕ: " Plants "
  ГОРЬКИЙ: " GORKIY "
  ГОРЬКИЙ-150: " Gorky-150 "
  ГОРЬКОВСКОЕ: " GORKOVSKAYA "
  ? "ГОРЯЧИЙ КЛЮЧ"
  : " HOT KEYS "
  ГОС-76: " GOS-76 "
  ГОСТИЛИЦЫ: " Gostilitsy "
  ГОСТИНОПОЛЬЕ: " Gostinopolye "
  ГОСТИЦЫ: " GOSTITSY "
  ГОТВАЛЬД: " Gottwald "
  ГОЩА: " Goshcha "
  ГРАХОВО: " Grahovo "
  ГРАЧЕВКА: " Grachevka "
  ГРЕБЕНКА: " Grebenki "
  ГРЕМЯЧИНСК: " Gremyachinsk "
  ГРЕС-19: " TPS-19 "
  ГРИБАНОВСКИЙ: " Gribanovsky "
  ГРИГОРИОПОЛЬ: " Grigoriopol "
  ГРОДНО: " Grodno "
  ГРОЗНЫЙ: " Grozny "
  ГРОХОВЕЦ: " GROHOVETS "
  ГРЯЗИ: " MUD "
  ГРЯЗОВЕЦ: " GRYAZOVETS "
  ГУБАХА: " ANNA"
  ГУБКИН: "GUBKIN "
  ГУДЕРМЕС: " GUDERMES "
  ГУЗАР: " GUZAR "
  ГУКОВО: " Gukovo "
  ГУЛБИНЕ: " GULBINE "
  ГУЛИСТАН: " GULISTAN "
  ГУЛЬБАХОР: " Gulbahor "
  ГУЛЬКЕВИЧИ: " Gulkevich "
  ГУЛЯЙПОЛЕ: " Gulyaypole "
  ГУРДЖААНИ: " Gurjani "
  ГУРЛЕН: " Hurlo "
  ГУРЬЕВ: " GURYEV "
  ГУРЬЕВСК: " Gurievsk "
  ГУСЕВ: " Gusev "
  ГУСИНООЗЕРСК: " Gusinoozyorsk "
  ? "ГУСЬ ХРУСТАЛЬНЫ"
  : " Gus Khrustalny "
  ГУСЯТИН: " Gusyatin "
  ГЯНДЖА: " GANJA "
  Д-КОНСТАНТИНОВО: " D-KONSTANTINOVO "
  ДАВЛЕКАНОВО: " Davlekanovo "
  ДАЛМАТОВО: " Dalmatovo "
  ДАЛЬНЕГОРСК: " Dalnegorsk "
  ДАЛЬНЕРЕЧЕНСК: " Dalnerechensk "
  ДАНГАРА: " Dangara "
  ДАНИЛОВ: " DANILOV"
  ДАНИЛОВКА: "Danilovka "
  ДАНКОВ: " Danko "
  ДАРГАН-АТА: " DARGAN-ATA "
  ДАРЬИНСКОЕ: " Darya "
  ДАУГАВПИЛС: " DAUGAVPILS "
  ДВУРЕЧНАЯ: " Dvurechnaya "
  ДЕБАЛЬЦЕВО: " Debalcevo "
  ДЕБЕССЫ: " DEBESSY "
  ДЕДОВИЧИ: " Djedovic "
  ДЕМИДОВ: " DEMIDOV "
  ДЕМЯНСК: " Demyansk "
  ДЕНАУ: " Dena "
  ДЕРАЖНЯ: " Derazhnya "
  ДЕРГАЧИ: " Dergachi "
  ? "ДЕРГАЧИ САРАТ"
  : " Dergachi Saratov "
  ДЕРЖАВИНСК: " Derzhavinsk "
  ДЕСНОГОРСК: " Desnogorsk "
  ДЖАЛАЛ-АБАД: " Jalalabad "
  ДЖАЛИЛАБАД: " Jelilabad "
  ДЖАМБАЙ: " Djambala "
  ДЖАМБЕЙТЫ: " Dzhambeita "
  ДЖАМБУЛ: " Zhambyl "
  ДЖАНКОЙ: " Djankoi "
  ДЖАНСУГУРОВО: " DZHANSUGUROVO "
  ДЖАНЫБЕК: " Janybekov"
  ДЖЕЗКАЗГАН: "Dzhezkazgan "
  ДЖЕРМУК: " JERMUK "
  ДЖЕТЫГАРА: " Dzhetygara "
  ДЖЕТЫСАЙ: " DZHETYSAY "
  ДЖИЗАК: " Dihzak "
  ДЖИЛККУЛЬ: " DZHILKKUL "
  ДЖИРГИТАЛЬ: " Jirgital "
  ДЖУМА: " Juma "
  ДЖУМАШУЙ: " DZHUMASHUY "
  ДЗЕРЖИНСК: " Dzerzhinsk "
  ДИВЕЕВО: " Diveevo "
  ДИВНОГОРСК: " Divnogorsk "
  ДИВНОЕ: " DIVNA "
  ДИГОРА: " Digor "
  ДИКАНЬКА: " DIKAN&#39;KI "
  ДИЛИЖАН: " DILIJAN "
  ДИМИТРОВОГРАД: " DIMITROVOGRAD "
  ДИНСКАЯ: " Dinskaya "
  ДМИТРИЕВ: " Dmitry "
  ДМИТРИЕВКА: " Dmitrievka "
  ДМИТРОВ: " Dmitry "
  ДМИТРОВСКОЕ: " Dmitrovskoe "
  ДНЕПРОДЗЕРЖИНСК: " Dniprodzerzhynsk "
  ДНЕПРОПЕТРОВСК: " Dnepropetrovsk "
  ДНЕПРОРУДНЫЙ: " ДНЕПРОРУДНЫЙ"
  ДОБЕЛЕ: "DOBELLE "
  ДОБРИНКА: " Dobrinka "
  ДОБРОВЕЛИЧКОВКА: " Dobrovelichkivka "
  ДОБРОЕ: " Welcome "
  ДОБРОПОЛЬЕ: " Dobropole "
  ДОБРУШ: " Dobrush "
  ДОВОЛЬНОЕ: " QUITE "
  ДОКУЧАЕВКА: " Dokuchaevka "
  ДОКУЧАЕВСК: " Dokuchaevsk "
  ДОКШИЦЫ: " Dokshitsy "
  ДОЛГОДЕРЕВЕНСК.: " DOLGODEREVENSK. "
  ДОЛГОЕ: " LONG "
  ДОЛГОРУКОВО: " Dolgorukova "
  ДОЛИНА: " VALLEY "
  ДОЛИНСК: " DOLINSKAYA "
  ДОЛИНСКАЯ: " DOLINSKAYA "
  ДОМАСАКА: " DOMASAKA "
  ДОМОДЕДОВО: " DOMODEDOVO "
  ДОНДЮШАНЫ: " Valeni "
  ДОНЕЦК: " Donetsk "
  ДОНЕЦК-РОСТ-ДОН: " Donetsk, Rostov-Don "
  ДОНЕЦКОЕ: " Donetsk "
  ДОРОГОБУШ: " DOROGOBUSH "
  ДРАБОВ: " Drabiv "
  ДРОГИЧИН: " Drahichyn"
  ДРОГОБЫЧ: "Drogobych "
  ДРОКИЯ: " DROCHIA "
  ДРУЖБА: " FRIENDSHIP "
  ДРУЖКОВКА: " Druzhkovka "
  ДРУСКИНИНКАЙ: " Druskininkai "
  ДУБЕНКИ: " Dubenka "
  ДУБНА: " Dubna "
  ДУБНО: " Dubna "
  ДУБОВКА: " Dubovka "
  ДУБОССАРЫ: " DUBASARI "
  ДУБРОВИЦА: " Dubrovitsy "
  ДУБРОВКА: " Dubrovka "
  ДУБРОВНО: " Dubroŭna "
  ДУЛЬДУРГА: " DULDURGA "
  ДУМБРАВЕНЫ: " Dumbrava "
  ДУМИНИЧИ: " DUMINICHI "
  ДУНАЕВЦЫ: " Dunaevcy "
  ДУРЛЕШТЫ: " Monroe "
  ДУСТИ: " DUSTOV "
  ДУХОВНИЦКОЕ: " DUHOVNITSKOE "
  ДУХОВЩИНА: " Dukhovshchina "
  ДУШАНБЕ: " Dushanbe "
  ДУШЕТИ: " Dusheti "
  ДЫЛЫМ: " Dylym "
  ДЮРТЮЛИ: " Dyurtyuli"
  ДЯТЛОВО: "Dyatlova "
  ДЯТЬКОВО: " Dyat&#39;kovo "
  ЕВЛАХ: " YEVLAKH "
  ЕВПАТОРИЯ: " Evpatoria "
  ЕГВАРД: " Yeghvard "
  ЕГИНДЫБУЛЫК: " EGINDYBULYK "
  ЕГОРЛЫК: " EGORLYK "
  ЕГОРЬЕВСК: " Yegor&#39;yevsk "
  ЕДИНЦЫ: " Edintsy "
  ЕЖЕГНАДЗОР: " EZHEGNADZOR "
  ЕЙСК: " YEISK "
  ЕКАБПИЛС: " JEKABPILS "
  ЕКАТЕРИНОВКА: " Ekaterinovka "
  ЕЛАБУГА: " ELABUGA "
  ЕЛАНЕЦ: " Elanets "
  ЕЛАНЬ: " ELAN "
  ЕЛГАВА: " JELGAVA "
  ЕЛЕЦ: " Elec "
  ЕЛИЗОВО: " Yelizovo "
  ЕЛОВО: " SPRUCE "
  ЕЛЬНИКИ: " Spruce "
  ЕЛЬНЯ: " Yelnya "
  ЕЛЬСК: " Yelsk "
  ЕЛЬЦОВКА: " ELTSOVKA "
  ЕМАНЖЕЛИНСК: " Emanzhelinsk"
  ЕМВА: "EMBA "
  ЕМЕЛЬЧИНО: " Emilchine "
  ЕМЕЛЬЯНОВО: " EMELIANOVA "
  ЕНАКИЕВО: " Enakieve "
  ЕНИСЕЙСК: " Yenisei "
  ЕНОТАЕВКА: " ENOTAEVKA "
  ЕРЕВАН: " Yerevan "
  ЕРМАК: " YERMAK "
  ЕРМАКОВСКОЕ: " ERMAKOVKA "
  ЕРМЕНТАУ: " Ermentau "
  ЕРМИШЬ: " ERMISH "
  ЕРШИЧИ: " ERSHICHI "
  ЕРШОВ: " ERSHOV "
  ЕСИЛЬ: " Yesil "
  ЕССЕНТУКИ: " ESSENTUKI "
  ЕТКУЛЬ: " ETKUL "
  ЕФРЕМОВ: " YEFREMOV "
  ЕХЕГНАДЗОР: " Yeghegnadzor "
  ЖАБИНКА: " Zhabinka "
  ЖАНАТАС: " Zhanatas "
  ЖАШКОВ: " Zhashkiv "
  ЖЕЛЕЗИНКА: " ZHELEZINKA "
  ЖЕЛЕЗНОВОДСК: " ZHELEZNOVODSK "
  ЖЕЛЕЗНОГ.-КУРСК: " ZHELEZNOG.-Kursk "
  ЖЕЛЕЗНОГОРСК-ИР: " Zheleznogorsk-IR"
  ЖЕЛТЫЕ-ВОДЫ: "YELLOW-WATER "
  ЖЕРДЕВКА: " Zherdevka "
  ЖИГУЛЕВСК: " Zhigulevsk "
  ЖИДАЧОВ: " Zhidachiv "
  ЖИЗДРА: " Zhizdra "
  ЖИРНОВСК: " Zhirnovsk "
  ЖИРЯТИНО: " ZHIRYATINO "
  ЖИТКОВИЧИ: " Zhytkavichy "
  ЖИТКОВО: " Zhitkova "
  ЖИТОМИР: " Zhitomir "
  ЖИХАРЕВО: " Zhikhareva "
  ЖЛОБИН: " ZHLOBIN "
  ЖМЕРИНКА: " Jmerinka "
  ЖОДИНО: " Zhodino "
  ЖОНДОР: " Jondor "
  ЖУКОВКА: " ZHUKOVKA "
  ЖУКОВО: " BEETLES "
  ЖУКОВСКИЙ: " ZHUKOVSKY "
  ЗААМИН: " Zaamin "
  ЗАБАЙКАЛЬСК: " TRANSBAIKALIAN "
  ЗАВЕТНОЕ: " TREASURED "
  ЗАВОДОУКОВСК: " Zavodoukovsk "
  ЗАВОЛЖЬЕ: " Transvolga "
  ЗАВЬЯЛОВО-БАРН.: " Zavjalova - Barney. "
  ЗАВЬЯЛОВО-УСТИН: " Zavjalova-Ustinov"
  ЗАГОРСК: "Zagorski "
  ЗАГРИВЬЕ: " ZAGRIVE "
  ЗАДОНСК: " Zadonsk "
  ЗАИГРАЕВО: " Zaigraevo "
  ЗАИНСК: " Zainsk "
  ЗАЙСАН: " Zaisan "
  ЗАКАМЕНСК: " Zakamensk "
  ЗАКАТЫЛЫ: " ZAKATYLY "
  ЗАЛАРИ: " ZALARI "
  ЗАЛЕГОЩЬ: " Zalegoshch "
  ЗАЛЕЖИКИ: " ZALEZHIKI "
  ЗАЛЕСОВО: " ZALESOVO "
  ЗАЛУКОКАЖЕ: " ZALUKOKAZHE "
  ЗАОЗЕРНЫЙ: " Zaozernaya "
  ЗАОКСКИЙ: " ZAOKSKY "
  ? "ЗАПАДНАЯ ДВИНА"
  : " Western Dvina "
  ЗАПОЛЯРНЫЙ: " Polar "
  ЗАПОРОЖЬЕ: " Zaporozhye "
  ЗАРАЙСК: " Zaraysk "
  ЗАРАСАЙ: " Zarasai "
  ЗАРЕЧНОЕ: " Zarechnoe "
  ЗАРИНСК: " Zarinsk "
  ЗАСТАВНА: " Zastavna "
  ЗАТОБОЛЬСК: " ZATOBOLSK "
  ЗАФАР: " Zafar"
  ЗАФАРОБАД: "ZAFAROBAD "
  ЗАЧЕПИЛОВКА: " Zachepilovka "
  ЗБАРАШ: " ZBARASH "
  ЗБОРОВ: " ZBOROV "
  ЗВЕНИГОВО: " Zvenigovo "
  ЗВЕНИГОРОД: " ZVENIGOROD "
  ЗВЕНИГОРОДКА: " Zvenigorodka "
  ЗГУРОВКА: " Zgurovka "
  ЗДВИНСК: " ZDVINSK "
  ЗДОЛБУНОВ: " Zdolbuniv "
  ЗЕЛЕНОГРАДСК: " Zelenogradsk "
  ЗЕЛЕНОДОЛЬСК: " ZELENODOLSK "
  ЗЕЛЕНЧУКСКАЯ: " Zelenchukskij "
  ЗЕЛЬВА: " Zelva "
  ЗЕМЕТЧИНО: " Zemetchino "
  ЗЕНЬКОВ: " Zenko "
  ЗЕРЕНДА: " Zerenda "
  ЗЕРНОГРАД: " Zernograd "
  ЗИАДИН: " ZIADIN "
  ЗИМА-ИРКУТСК: " WINTER-IRKUTSK "
  ЗИМОВНИКИ: " Zimovniki "
  ЗЛАТОУСТ: " ЗЛАТОУСТ "
  ЗМЕИНОГОРСК: " Zmeinogorsk "
  ЗМИЕВКА: " Zmievka "
  ЗНАМЕНКА-КИРОВО: " Znamenka-Kirov"
  ЗНАМЕНКА-ТАМБОВ: "Znamenka Tambo "
  ЗНАМЕНСКОЕ-ГРОЗ: " ZNAMENSKY-STORM "
  ЗНАМЕНСКОЕ-ОМСК: " ZNAMENSKY-DHBs "
  ЗОЛОТОНОША: " Zolotonosha "
  ЗОЛОТУХИНО: " ZOLOTUKHIN "
  ЗОЛОЧЕВ-ЛЬВОВ: " Zolochev-Lviv "
  ЗОЛОЧЕВ-ХАРЬКОВ: " Zolochev-Kharkov "
  ЗОНАЛЬНОЕ: " Zoned "
  ? "ЗУБОВА ПОЛЯНА"
  : " ZUBOVA fields "
  ЗУБЦОВ: " Zubtsov "
  ЗУЕВКА: " Zuevka "
  ЗЫРЯНОВСК: " Zyryanovsk "
  ЗЫРЯНСКОЕ: " ZYRJANIAN "
  ИБРЕСИ: " Ibresi "
  ИВАНГОРОД: " Ivangorod "
  ИВАНИЧИ: " Ivanichi "
  ИВАНКОВ: " IVANKA "
  ИВАНО-АЛЕКСЕЕВК: " Ivano-Alekseevka "
  ИВАНО-ФРАНКОВСК: " Ivano -Frankovsk "
  ИВАНОВКА: " Ivanovka "
  ИВАНОВКА-ОДЕССА: " Ivanovka-Odessa "
  ИВАНОВКА-ФРУНЗЕ: " Ivanovka-FRUNZE "
  ИВАНОВКА-ХЕРСОН: " Ivanovka-HERSON "
  ИВАНОВО: " Ivanovo "
  ИВАНОВО-БРЕСТ: " Ivanovo-Brest"
  ИВАНТЕЕВКА: "Ivanteevka "
  ИВАНЦЕВИЧИ: " IVANTSEVICHI "
  ИВНЯ: " IVNYA "
  ИВОЛГИНСК: " Ivolginsky "
  ИВЬЕ: " Iŭie "
  ИГЛИНО: " Iglina "
  ИГНАЛИНА: " Ignalina "
  ИГРА: " Game "
  ИДЖЕВАН: " IJEVAN "
  ИДРИНСКОЕ: " IDRINSKOE "
  ИЕЕТСКОЕ: " IEETSKOE "
  ИЖЕВСК: " Izhevsk "
  ИЖМА: " Izhma "
  ИЖМОРСКИЙ: " IZHMORSKY "
  ИЗМАИЛ: " IZMAIL "
  ИЗМАЛКОВО: " Political Parties "
  ИЗОБИЛЬНЫЙ: " Izobilnoe "
  ИЗЮМ: " RAISINS "
  ИЗЯСЛАВ: " Izyaslav "
  ИКИ-БУРУЛ: " IKI-Burul "
  ИКРЯНОЕ: " roe "
  ИЛАНСКИЙ: " Ilan "
  ИЛЕК: " ILEC "
  ИЛОВАЙСК: " Ilovaisk "
  ИЛОВЛЯ: " ILOVLYA"
  ИЛЬИНСКИЙ: "Ilinskij "
  ИЛЬИНСКО-ПОДОМС: " Ilinskij-PODOMS "
  ИЛЬИНСКОЕ-ХАВАН: " Ilinskij-Hawa "
  ИЛЬИНЦЫ: " Ilincy "
  ИЛЬЯЛЫ-ТАШАУЗ: " ILYALY-Dashuz "
  ИМАНЬ: " Miracles Of The Quran "
  ИНЗА: " Inza "
  ИНСАР: " INSAR "
  ИНТА: " INTA "
  ИОЛОТАНЬ: " Iolotan "
  ИОНАВА: " Ionava "
  ИОНИШКИС: " Joniškis "
  ИПАТОВО: " Ipatova "
  ИРБЕЙСКОЕ: " IRBEYSKOE "
  ИРБИТ: " Irbit "
  ИРИНОВКА: " IRINOVKA "
  ИРКУТСК: " Irkutsk "
  ИРПЕНЬ: " Irpen "
  ИРТЫШСК: " Irtysh "
  ИРШАВА: " Irshava "
  ИСАКЛЫ: " Isakly "
  ИСЕТСКОЕ: " Isetskij "
  ИСИЛЬКУЛЬ: " Isilkul "
  ИСКИТИМ: " ISKIT "
  ИСМАИЛЛЫ: " ISMAILLI"
  ИССЫК: "ISSYK "
  ИСТРА: " Istra "
  ИСФАНА: " Isfana "
  ИСФАРА: " Isfara "
  ИСЯНГУЛОВО: " ISYANGULOVO "
  ИТЫК-КЮЕЛЬ: " ITYK-Kyuyol "
  ИЧНЯ: " Ichnya "
  ИШЕЕВКА: " ISHEEVKA "
  ИШИМБАЙ: " Ishimbaj "
  ИШТЫХАН: " ISHTYHAN "
  ЙОШКАР-ОЛА: " Yoshkar-Ola "
  ЙЫГЕВА: " Jõgeva "
  КААХКА: " Kaka "
  КАВАЛЕРОВО: " Kavalerov "
  КАВКАЗСКАЯ: " Caucasus "
  КАГАЛЬНИЦКАЯ: " Kagalnitskaya "
  КАГАН: " Kagan "
  КАГАРЛЫК: " Kagarlyk "
  КАГУЛ: " CAHUL "
  КАДОМ: " Kadom "
  КАДУЙ: " Kadui "
  КАДЫЙ: " Kady "
  КАЗАНДЖИК: " Cazangic "
  КАЗАНКА: " KAZANKA "
  КАЗАНСКОЕ: " Kazan"
  КАЗАНЬ: "KAZAN "
  КАЗАРМАН: " Kazarman "
  КАЗАТИН: " Kazatin "
  КАЗАХ: " KAZAKHS "
  КАЗАЧИНСКОЕ: " Kazachinsko "
  КАЗТАЛОВКА: " Kaztalovka "
  КАИНДА: " Kaindy "
  КАЙРАККУМ: " Kairakkum "
  КАЙШЯДОРИС: " Kaisiadorys "
  КАЛАНЧАК: " Kalanchak "
  КАЛАРАШ: " Calarasi "
  КАЛАЧ: " KALACHEV "
  ? "КАЛАЧ НА ДОНУ"
  : " KALACHEV FOR DON "
  КАЛАЧИНСК: " Kalachinskaya "
  КАЛГА: " Kalga "
  КАЛЕВАЛА: " KALEVALA "
  КАЛИНИН: " Kalinin "
  КАЛИНИНГРАД: " Kaliningrad "
  КАЛИНИНО: " Kalinin "
  КАЛИНИНСКАЯ: " KALININSKAYA "
  КАЛИНКОВИЧИ: " Kalinkovichi "
  КАЛИНОВКА: " Kalinovka "
  КАЛМАНКА: " Kalmanka "
  КАЛУГА: " Kaluga "
  КАЛУШ: " KALUSH"
  КАЛЯЗИН: "Kalyazin "
  КАМ-КАШИРСКИЙ: " KAM-Kashirskiy "
  КАМАШИ: " Kamashi "
  КАМБАРКА: " Kambarka "
  КАМЕНЕЦ: " KAMIANETS "
  КАМЕНЕЦ-ПОДОЛЬС: " KAMIANETS-PODOLS "
  КАМЕНКА: " KAMENKA "
  КАМЕНКА-БУГСКАЯ: " Kamenka-Buzka "
  КАМЕНКА-ВОРОНЕЖ: " KAMENKA-Voronezh "
  КАМЕНКА-ДНЕПР: " KAMENKA-Dnepr "
  КАМЕНКА-КИШИНЕВ: " KAMENKA-Chisinau "
  КАМЕНКА-ТОСНО: " KAMENKA-Tosno "
  КАМЕНКА-УРАЛЬСК: " KAMENKA URALSKY "
  КАМЕНКА-ЧЕРКАСС: " KAMENKA-Cherkassy "
  КАМЕНОГОРСК: " ALMATY "
  КАМЕНОЛОМНЯ: " Quarries "
  КАМЕНСК: " KAMENSK "
  КАМЕНСК-УРАЛЬСК: " KAMENSK URALSKY "
  КАМЕНЬ-НА-ОБИ: " Kamen-na-Obi "
  КАМЕНЬ-РЫБОЛОВ: " STONE-Fisherman "
  КАМЕШКОВО: " Kameshkovo "
  КАМО: " KAMO "
  ? "КАМСКОЕ УСТЬЕ"
  : " Kama MOUTH "
  КАМЫЗЯК: " Kamyzyak "
  КАМЫШЕВКА: " Sedge"
  КАМЫШИН: "Kamyshin "
  КАМЫШНОЕ: " Kamyshny "
  КАНАШ: " Canas "
  КАНГОЛАСЫ: " KANGOLASY "
  КАНДАЛАКША: " Kandalaksha "
  КАНЕВ: " Kanev "
  КАНЕВСКАЯ: " KANEVSKY "
  КАНЕМИР: " KANEMIR "
  КАНИБАДАМ: " Kanibadam "
  КАНИМЕХ: " Kanimeh "
  КАНСК: " KAN "
  КАНТ: " KANT "
  КАНТЕМИР: " Cantemir "
  КАНТЕМИРОВКА: " Kantemirovka "
  КАПАЛ: " CAPA "
  ? "КАПУСТИН ЯР"
  : " Kapustin Yar "
  КАПЧАГАЙ: " KAPCHAGAY "
  КАРА-БАЛТА: " Kara-Balta "
  КАРА-КАЛА: " Kara-Kala "
  КАРА-СУУ: " Kara-Suu "
  КАРАБЕКАУЛ: " KARABEKAUL "
  КАРАБУДАХКЕНТ: " Karabudakhkent "
  КАРАБУЛАК: " Karabulak "
  КАРАВАН: " CARAVAN "
  КАРАГАЙ: " Karagan"
  КАРАГАЙЛЫ: "Karagaily "
  КАРАГАЛИНСКОЕ: " KARAGALINSKOE "
  КАРАГАНДА: " ALMATY "
  КАРАЖАЛ: " Karazhan "
  КАРАИДЕЛЬ: " Karaidel "
  КАРАКУЛИНО: " Karakulin "
  КАРАКУЛЬ-БУХАРА: " Kara-Bukhari "
  КАРАКУЛЬ-ТАЛАС: " Kara-Talas "
  КАРАКУШЧИ: " KARAKUSHCHI "
  КАРАСУ: " KARAS "
  КАРАСУК: " Karasuk "
  КАРАТОБЕ: " Karatobe "
  КАРАТУЗСКОЕ: " Karatuzsky "
  КАРАУЗЯК: " Karauzyak "
  КАРАУЛ-СЕМИПАЛА: " Karaul Semipalatinsk "
  КАРАУЛ-УРГЕНЧ: " GUARDS-Urgench "
  КАРАЧЕВ: " Karachi "
  КАРГАПОЛЬЕ: " Kargapolov "
  КАРГАСОК: " Kargasok "
  КАРГАТ: " Kargath "
  КАРДЫМОВО: " KARDYMOVO "
  КАРКАРАЛИНСК: " KARKARALINSK "
  КАРЛОВКА: " Karlovka "
  КАРМАНА: " Pocket "
  КАРМАСКАЛЫ: " KARMASKALY"
  КАРПИНСК: "KARPINSKY "
  КАРСУН: " KARSUN "
  КАРТАЛЫ: " Kartal "
  КАРШИ: " KARSHI "
  КАРЫМСКОЕ: " KARYMSKY "
  КАСАН: " CASA "
  КАСАНСАЙ: " KASANSAY "
  КАСИМОВ: " KASIMOV "
  КАСКЕЛЕН: " Kaskelen "
  КАСЛОВКА: " KASLOVKA "
  КАСЛЫ: " Castle "
  КАСПИ: " KASPI "
  КАСПИЙСКИЙ: " CASPIAN "
  КАСТОРНОЕ: " Kastornoye "
  КАТАВ-ИВАНОВСК: " Kata Ivanovsk "
  КАТАЙСК: " Katajsk "
  КАТЕРИНОПОЛЬ: " Katerinopil "
  КАТОВО: " Katoff "
  КАТОН: " KATONA "
  КАТТАКУРГАН: " Kattakurgan "
  КАУНАС: " Kaunas "
  КАУШАНЫ: " Kaushany "
  КАФАН: " KAFA "
  КАХОВКА: " Kakhovka "
  КАЧИРЫ: " KACHIRY"
  КАЧКАНАР: "Kachkanar "
  КАШИН: " KASHIN "
  КАШИРА: " Kashira "
  КАШИРСКОЕ: " Kashirskij "
  КБАН: " KBAN "
  КЕГЕЙЛИ: " Kegeyli "
  КЕГЕНЬ: " Kegen "
  КЕГИЧЕВКА: " Kegichevka "
  КЕДАЙНЯЙ: " Kedainiai "
  КЕЛЕС: " Keles "
  КЕЛЛЕРОВКА: " KELLEROVKA "
  КЕЛЬМЕ: " Kelme "
  КЕЛЬМЕНЦЫ: " Kelmentsi "
  КЕМЕРОВО: " Kemerovo "
  КЕМЛЯ: " smb "
  КЕМЬ: " Kem "
  КЕНТАУ: " Kentau "
  КЕРЧЬ: " Kerch "
  КЕТОВО-ГОРЬКИЙ: " Ketov-GORKIY "
  КЕТОВО-КУРГАН: " Ketov-Hill "
  КЗЫЛ-ОРДА: " Qyzylorda "
  КЗЫЛТУ: " KZYLTU "
  КИБРАЙ: " Kibray "
  КИВЕРЦЫ: " Kivercy "
  КИЕВ: " KIEV"
  КИЕВКА: "Kievka "
  КИЖИНГА: " KIZHINGA "
  КИЗЕЛ: " Kizel "
  КИЗИЛ-АТРЕК: " Kizil Atrek "
  КИЗИЛЬСКОЕ: " KIZILSKOE "
  КИЗНЕР: " Kizner "
  КИЗЫЛ-АРВАТ: " Kyzyl-Arvat "
  КИЙМА: " KIYMA "
  КИКВИДЗЕ: " Kikvidze "
  КИКЕРИНО: " KIKERINO "
  КИЛЕМАРЫ: " KILEMARY "
  КИЛИЯ: " Kiliya "
  КИМОВСК: " Kimovsk "
  КИМРЫ: " Cymru "
  КИНГИСЕПП: " Kingisepp "
  КИНЕЛЬ: " Kinel "
  КИНЕЛЬ-ЧЕРКАССЫ: " Kinel-Cherkassy "
  КИНЕШМА: " Kineshma "
  КИПЕНЬ: " BOILING POINT "
  КИРГИЗ-МИЯКИ: " KYRGYZSTAN-Miyako "
  КИРЕЕВСК: " Kireevsk "
  КИРЕНСК: " Kirensk "
  КИРЖАЧ: " Kirzhach "
  КИРИЛЛОВ: " Kirill "
  КИРИШИ: " Kirishi"
  КИРИШСКИЙ-НЕФЗА: "Kirishskaya-NEFZA "
  КИРОВ: " Kirov "
  КИРОВ-КАЛУГА: " Kirov-KALUGA "
  КИРОВАКАН: " Vanadzor "
  КИРОВКА: " markings "
  КИРОВО: " Kirov "
  КИРОВОГРАД-СВРД: " Kirovograd-SVRD "
  КИРОВОГРАД-УАК2: " Kirovograd-UAK2 "
  КИРОВОЧЕПЕЦК: " KIROVOCHEPETSK "
  КИРОВСК: " KIROVSKY "
  КИРОВСКИЙ: " KIROV "
  КИРОВСКОЕ: " KIROV "
  КИРОВСКОЕ.: " Kirovsk. "
  КИРПИЧНОЕ: " BRICK "
  КИРСАНОВ: " Kirsanov "
  КИСИЛЕВСК: " Kisilevskii "
  КИСЛОВОДСК: " Kislovodsk "
  КИТАБ: " Kitab "
  КИЦМАНЬ: " Kicman "
  ? "КИЧМЕНГСКИЙ ГОР"
  : " Kichmengsky HIGHLAND "
  КИШИНЕВ: " CHISINAU "
  КИЯСОВО: " Kijasovo "
  КЛАЙПЕДА: " Klaipeda "
  КЛЕТНЯ: " KLETNYA "
  КЛЕТСКИЙ: " Kletskaya"
  КЛЕЦК: "Kletsk "
  КЛИМОВИЧИ: " KLIMOVICH "
  КЛИМОВО-БРЯНСК: " Klimova-BRYANSK "
  КЛИМОВО-ВЫБОРГ: " Klimova-VYBORG "
  КЛИН: " KLIN "
  КЛИНЦЫ: " Klintsov "
  КЛИЧЕВ: " Klichev "
  КЛЮЧИ: " KEYS "
  КЛЯВЛИНО: " Klyavlin "
  КОБЕЛЯКИ: " Kobelyaki "
  КОБРИН: " Kobrin "
  КОВДОР: " Kovdor "
  КОВЕЛЬ: " Kovel "
  КОВЕРНИНО: " KOVERNINO "
  КОВРОВ: " CARPET "
  КОВЫЛКИНО: " Kovylkino "
  КОДЫМА: " Kodima "
  КОЗЕЛЕЦ: " Kozelec "
  КОЗЕЛЬСК: " Kozelsk "
  КОЗЕЛЬЩИНА: " Kozelshchina "
  КОЗЛОВКА: " Kozlovka "
  КОЗОВА: " Kozova "
  КОЗТАЛОВКА: " KOZTALOVKA "
  КОЗУЛЬКА: " KOZULKA "
  КОЗЬМОДЕМЬЯНСК: " Kozmodemyansk"
  КОЙГОРОДОК: "Koygorodok "
  КОКАНД-ТАШКЕНТ: " Kokand, Tashkent "
  КОКАНД-ФЕРГАНА: " KOKAND-FERGHANA "
  КОКПЕКТЫ: " Kokpekty "
  КОКЧЕТАВ: " Kokchetav "
  КОЛА: " COLA "
  КОЛОГРИВ: " Kologriv "
  КОЛОМНА: " Kolomna "
  КОЛОМЫЯ: " Kolomyia "
  КОЛОСОВКА: " Kolosovka "
  КОЛПАШЕВО: " Kolpashevo "
  КОЛПНА: " KOLPNA "
  КОЛТОН: " Colton "
  КОЛХОЗОБАД: " KOLHOZOBAD "
  КОЛЧАНОВО: " Kolchanova "
  КОЛЫВАНЬ: " Kolyvan "
  КОЛЫШЛЕЙ: " Kolyshley "
  КОЛЬЧУГИНО: " Kolchugino "
  КОМАРИЧИ: " Komarichev "
  ? "КОМБИНАТ ФОСФОР"
  : " PLANT PHOSPHORUS "
  КОМИНТЕРНОВСК: " Kominternovskoe "
  КОММУНАР: " Komunar "
  КОММУНАРСК: " Kommunarsk "
  КОММУНИСТИЧЕСКЙ: " COMMUNIST "
  КОМПАНЕЕВКА: " Kompaniyivka"
  КОМРАТ: "COMRAT "
  КОМСОМОЛЕЦ: " KOMSOMOLETS "
  КОМСОМОЛОБАД: " KOMSOMOLOBAD "
  КОМСОМОЛЬСК: " Komsomolsk "
  КОМСОМОЛЬСКИЙ: " Komsomolsk "
  КОМСОМОЛЬСКОЕ: " Komsomolsk "
  КОНАКОВО: " Konakova "
  КОНДИНСКОЕ: " Kondinsky "
  КОНДОПОГА: " KONDOPOGA "
  КОНДРОВО: " Kondrovo "
  КОНОТОЛ: " KONOTOL "
  КОНСТАНТИНОВКА: " KOSTIANTYNIVKA "
  КОНСТАНТИНОВСК: " Konstantinovsky "
  КОНЫШЕВКА: " Konyshevka "
  КОПЕЙСК-ЧЕЛЯБ.: " Kopeysk-Chelyaba. "
  КОПОРЬЕ: " Koporje "
  КОПЫЛЬ: " Kopyl "
  КОРАБЛИНО: " Korablin "
  КОРЕЛИЧИ: " Karelichy "
  КОРЕНЕВО: " Koreneva "
  КОРЕНОВСК: " Korenovsk "
  КОРЕЦ: " KORETS "
  КОРКИНО-ТОСНО: " Korkin-Tosno "
  КОРКИНО-ЧЕЛЯБ.: " Korkin-Chelyaba. "
  КОРМА: " FEED"
  КОРМИЛОВКА: "Kormilovka "
  КОРНЕЕВКА: " Korneevka "
  КОРОЛЕВЕЦ: " KOROLEVETS "
  КОРОП: " Korop "
  КОРОСТЕНЬ: " KOROSTEN "
  КОРОСТЫШЕВ: " Korostishiv "
  КОРОЧА: " SHORT "
  КОРСАКОВ: " KORSAKOV "
  КОРСУНЬ-ШЕВЧЕНК: " Korsun-Shevchenko "
  КОРТКЕРОС: " KORTKEROS "
  КОРЮКОВКА: " Koryukovka "
  КОСИХА: " KOSIHA "
  КОСОВ: " Kosovo "
  КОСТЕРОВО: " KOSTEROVO "
  КОСТОМУКША: " KOSTOMUKSHA "
  КОСТОПОЛЬ: " Kostopol "
  КОСТРОМА: " Kostroma "
  КОСТЮКОВИЧИ: " Kostiukovicy "
  КОТАЙСК: " Kotayk "
  КОТЕЛЬВА: " Kotelva "
  КОТЕЛЬНИКОВО: " Nyquist "
  КОТЕЛЬНИЧ: " Kotelnich "
  КОТЛАС: " Kotlas "
  КОТЛЫ: " BOILERS "
  КОТОВО-ВОЛГОГР.: " CATS-VOLGOGR."
  КОТОВО-ГОРЬКИЙ: "CATS-GORKIY "
  КОТОВСК-КИШИНЕВ: " Kotovsk-Chisinau "
  КОТОВСК-ОДЕССА: " Kotovsk-Odessa "
  КОТОВСК-ТАМБОВ: " Kotovsk Tambo "
  КОХТЛА-ЯРВЕ: " Kohtla-Jarve "
  КОЧ-АГАЧ: " Koch-Agach "
  КОЧЕНЕВО: " Kochenevo "
  КОЧКИ: " Hummocks "
  КОЧКОРКА: " Kochkorka "
  КОЧКУРОВО: " KOCHKUROVO "
  КОШ-АГАЧ: " Kosh-Agach "
  КОШКИ: " CATS "
  КОШКУПЫР: " KOSHKUPYR "
  КР.-ГВАРДЕЙСКОЕ: " KR.-KUYBYSHIVSKE "
  КР.ГВАРДЕЙСКОЕ: " KR.GVARDEYSKOE "
  КР.ЛИМАР-ДОНЕЦК: " CD . Limar-Donetsk "
  КРАМАТОРСК: " Kremenchuk "
  КРАСИЛОВ: " Krasilov "
  КРАСЛАВА: " Kraslava "
  ? "КРАСНАЯ ГОРА"
  : " RED MOUNTAIN "
  ? "КРАСНАЯ ГОРБАТК"
  : " RED Gorbatko "
  КРАСНОАРМЕЙСК: " RED ARMY "
  ? "КРАСНОАРМЕЙСК С"
  : " RED ARMY S "
  КРАСНОАРМЕЙСКАЯ: " RED ARMY "
  КРАСНОАРМЕЙСКОЕ: " RED ARMY"
  КРАСНОБОРСК: "Krasnoborskaya "
  КРАСНОВОДСК: " Krasnovodsk "
  КРАСНОГВАРДЕЙСК: " Krasnogvardejsk "
  КРАСНОГОРОДСКОЕ: " Krasnogorodskoye "
  КРАСНОГОРСКОЕ: " KRÁSNOHORSKÉ "
  КРАСНОГРАД: " Krasnograd "
  КРАСНОДАР: " Krasnodar "
  КРАСНОДОН: " KRASNODON "
  КРАСНОЕ: " Red "
  КРАСНОЕ-НА-ВОЛ: " RED-ON-Hiv "
  КРАСНОЕЛЬСК: " KRASNOELSK "
  КРАСНОЗНАМЕНСК: " Krasnoznamensk "
  КРАСНОЗНАМЕНСКО: " Krasnoznamensk "
  КРАСНОКАМСК: " Krasnokamsk "
  КРАСНОКУТСК: " Krasnokutsk "
  КРАСНООЗЕРСКОЕ: " KRASNOOZERSKOE "
  КРАСНОПЕРЕКОПСК: " Krasnoperekopsk "
  КРАСНОПОЛЬЕ: " KRASNOPOL "
  КРАСНОСЕЛЬСК: " Krasnoselsk "
  КРАСНОСЕЛЬСКОЕ: " Krasnosel&#39;skii "
  КРАСНОСЛОБОДСК: " Krasnoslobodsk "
  КРАСНОТУРАНСК: " KRASNOTURANSK "
  КРАСНОТУРЬИНСК: " Krasnotur&#39;insk "
  КРАСНОУРАЛЬСК: " Krasnouralsk "
  КРАСНОУСОЛЬСКИЙ: " Krasnousolsk"
  КРАСНОУФИМСК: "Krasnoufimsk "
  КРАСНОЩЕКОВО: " Krasnoshchekova "
  КРАСНОЯРСК: " Krasnoyarsk "
  ? "КРАСНЫЕ ОКНА"
  : " RED DOORS "
  КРАСНЫЙ: " Red "
  ? "КРАСНЫЙ БОР"
  : " Red pine forest "
  ? "КРАСНЫЙ КУТ"
  : " Krasny Kut "
  ? "КРАСНЫЙ ЛУЧ"
  : " RED RAY "
  ? "КРАСНЫЙ СУЛИН"
  : " Krasny Sulin "
  ? "КРАСНЫЙ ЧИКОЙ"
  : " RED Chikoi "
  ? "КРАСНЫЙ ЯР"
  : " RED Yar "
  КРЕМЕНЕЦ: " Kremenets "
  КРЕМЕННАЯ: " KREMEN "
  КРЕМЕНЧУГ: " Kremenchug "
  КРЕСТЦЫ: " Krestcy "
  КРЕТИНГА: " Kretinga "
  ? "КРИВОЕ ОЗЕРО"
  : " CURVE LAKE "
  ? "КРИВОЙ РОГ"
  : " Krivoy Rog "
  КРИНИЧКИ: " Krinichki "
  КРИУЛЯНЫ: " CRIULENI "
  КРИЧЕВ: " SHOUT "
  КРОМЫ: " EXCEPT "
  КРОПОТКИН: " Kropotkin "
  КРУГЛОЕ: " Round "
  КРУПКИ: " Krupki"
  КРУТИНКА: "KRUTINKA "
  КРУТИХА: " KRUTIHA "
  КРЫЖОПОЛЬ: " Krizhopil "
  КРЫЛОВСКАЯ: " Krylovskaya "
  КРЫМСК: " Crimean "
  КСТОВО: " Kstovo "
  КУБА: " Cuba "
  КУВА: " Kuva "
  КУВАНДЫК: " Kuvanduk "
  КУВАСАЙ: " Kuvasai "
  КУВШИНОВО: " Kuvshinova "
  КУГАЛЫ: " KUGALY "
  КУГЕСИ: " Kugesi "
  КУДЫМКАР: " Kudymkar "
  КУЕДА: " KUEDA "
  КУЖЕНЕР: " KUZHENER "
  КУЗЕМКИНО: " Kuzemkin "
  КУЗНЕЦК: " KUZNETSK "
  КУЗНЕЦОВСК: " Kuznetsovsk "
  КУЗОВАТОВО: " Kuzovatovo "
  КУЙБ844ЯЯ: " KUYB844YAYA "
  КУЙБЫШЕВ: " Kuibyshev "
  КУЙБЫШЕВ-КАЗАНЬ: " Kuibyshev, Kazan "
  КУЙБЫШЕВ-НОВОСБ: " Kuibyshev - NOVOSB "
  КУЙБЫШЕВО: " Kuybisheve"
  КУЙБЫШЕВСК: "SHAKHTARSKE "
  КУЙБЫШЕВСКИЙ: " SHAKHTARSKE "
  КУЙВОЗИ: " KUYVOZI "
  КУЙГАНЯР: " Kuyganyar "
  КУЛДИГА: " Kuldiga "
  КУЛЕБАКИ: " Kulebaki "
  КУЛИКОВКА: " Kulikovka "
  КУЛУНДА: " Kulunda "
  КУЛЯБ: " Kulyab "
  КУМЕНЫ: " KUMENY "
  КУМЕРТАУ: " Kumertau "
  КУМКУРГАН: " Kumkurgan "
  КУМЫЛЖЕНСКАЯ: " KUMYLZHENSKAYA "
  КУНАШАК: " KUNASHAK "
  КУНГРАД: " Kungrad "
  КУНГУР: " KUNGUR "
  КУНЬЯ: " Cunha "
  КУНЯ-УРГЕНЧ: " Old Urgench "
  КУПИНО: " Bush "
  КУПИШКИС: " Kupiskis "
  КУПЯНСК: " Kupiansk "
  КУРАГИНО: " Kuragin "
  КУРАХОВО: " Kurakhovo "
  КУРГАЛЬДЖИНСКИЙ: " Kurgaldzhinskoye "
  КУРГАН: " BARROW"
  КУРГАН-ТЮБЕ: "Kurgan-Tube "
  КУРГАНИНСК: " Kurganinsk "
  КУРГАНТЕПА: " Kurgantepa "
  КУРЕСААРЕ: " Kuressaare "
  КУРКИНО: " KURKINO "
  КУРСАВКА: " Kursavka "
  КУРСК: " Kursk "
  КУРТАМЫШ: " Kurtamysh "
  КУРУМКАН: " Kurumkan "
  КУРЧАТОВ: " KURCHATOV "
  КУРЧУМ: " Kurchum "
  КУРЫМКАР: " KURYMKAR "
  КУРЬЯ: " Kurya "
  КУСА: " Kusa "
  КУСАРЫ: " Kusari "
  КУСИНО: " Cousiño "
  КУСТАНАЙ: " Kustanai "
  КУТАИСИ: " KUTAISI "
  КУТУЗОВ: " KUTUZOV "
  КУШВА: " Kushva "
  КУШНАРЕНКОВО: " KUSHNARENKOVO "
  КУЩЕВСКАЯ: " Kushchevskaya "
  КШЕНСКИЙ: " KSHENSKY "
  КЫЗЫЛ: " KYZYL "
  КЫЗЫЛ-КИЯ: " Kyzyl-Kiya"
  КЫЗЫЛТЕПА: "Kızıltepe "
  КЫТМАНОВО: " KYTMANOVO "
  КЫШТОВКА: " KYSHTOVKA "
  КЫШТЫМ: " Kyshtym "
  КЯРДЛА: " Kärdla "
  КЯХТА: " Kjahta "
  ЛАБИНСК: " labinsk "
  ЛАГОДЕХИ: " Lagodekhi "
  ЛАДУШКИН: " Ladushkin "
  ЛАДЫЖИН: " Ladyzhin "
  ЛАЗАРЕВСКОЕ: " LAZAREVSKOE "
  ЛАЗДИЯЙ: " Lazdijai "
  ЛАЗО: " Lazo "
  ЛАЗОВСК: " Lazo "
  ЛАИШЕВО: " Laish "
  ЛАНОВЦЫ: " Lanovcy "
  ЛАНШ: " LANSH "
  ЛАХДЕНПОХЬЯ: " Lahdenpohja "
  ЛЕБЕДИН: " SWAN "
  ЛЕБЕДИНОВКА: " Lebedinovka "
  ЛЕБЕДЯНЬ: " Lebedyan "
  ЛЕБЯЖЬЕ-КИРОВ: " Swan-Kirov "
  ЛЕБЯЖЬЕ-КУРГАН: " Swan-Hill "
  ЛЕБЯЖЬЕ-ЛОМОНОС: " Swan-Lomonosov "
  ЛЕБЯЖЬЕ-ПАВЛОД.: " Swan-PAVLOD."
  ? "ЛЕВ ТОЛСТОЙ"
  : "Leo Tolstoy "
  ЛЕЖНЕВО: " Lezhneva "
  ЛЕЛЬЧИЦЫ: " Lelchitsy "
  ЛЕНГЕР: " Lengerich "
  ЛЕНИНАБАД: " Leninabad "
  ЛЕНИНАКАН: " Leninakan "
  ЛЕНИНГРАД: " LENINGRAD "
  ЛЕНИНГРАДСКАЯ: " St. Petersburg "
  ЛЕНИНГРАДСКИЙ: " St. Petersburg "
  ЛЕНИНОГОРСК: " Leninogorsk "
  ЛЕНИНОПОЛЬ: " LENINOPOL "
  ЛЕНИНСК-АНДИЖАН: " Leninsk-Andijan "
  ЛЕНИНСК-ВОЛГОГР: " Leninsk-VOLGOGR "
  ЛЕНИНСК-КЗ-ОРДА: " Leninsk-BB-Orda "
  ЛЕНИНСК-КУЗНЕЦК: " Leninsk-Kuznetsk "
  ЛЕНИНСК-ТАШАУЗ: " Leninsk-Dashuz "
  ЛЕНИНСКИЙ-ДУШАН: " LENINSKIY-Soul "
  ЛЕНИНСКИЙ-КОКЧТ: " LENINSKIY -KOKCHT "
  ЛЕНИНСКИЙ-ТУЛА: " LENINSKIY-Tula "
  ЛЕНИНСКОЕ-КУСТ.: " Leninsk-BUSH. "
  ЛЕНИНСКОЕ-ХАБАР: " Leninsk-Khabar "
  ЛЕНКОРАНЬ: " LANKARAN "
  ЛЕНСК: " Lensk "
  ЛЕОВО: " LEOVA "
  ЛЕПЕЛЬ: " Lepel"
  ЛЕПСАРЫ: "LEPSARY "
  ЛЕПСЫ: " LEPSE "
  ЛЕРМОНТОВ: " LERMONTOV "
  ЛЕСНОЕ: " FORESTRY "
  ЛЕСНОС: " LESNOS "
  ЛЕСОГОРСКИЙ: " LESOGORSKY "
  ЛЕСОЗАВОД: " Sawmill "
  ЛЕСОЗАВОДСК: " Lesozavodsk "
  ЛЕСОКОМБИНАТ: " lesokombinat "
  ЛЕСОСИБИРСК: " Lesosibirsk "
  ЛЕТИЧЕВ: " Letichiv "
  ЛИВНЫ: " LIVNI "
  ЛИВОЗЕРОВО: " LIVOZEROVO "
  ЛИДА: " LIDA "
  ЛИЕПАЯ: " RIGA "
  ЛИМАН: " Lima "
  ЛИМБАЖИ: " Limbazhi "
  ЛИОЗНО: " Lioznov "
  ЛИПЕЦК: " LIPETSK "
  ? "ЛИПИН БОР"
  : " Lipin BOR "
  ? "ЛИПКАЯ ГОРКА"
  : " STICKY HILL "
  ЛИПКИ: " STICKY "
  ? "ЛИПОВАЯ ДОЛИНА"
  : " Lime VALLEY "
  ЛИПОВЕЦ: " Lipovec "
  ЛИСАКОВСК: " Lisakovsk"
  ЛИСИНО-КОРПУС: "LISINO-HULL "
  ЛИСИЧАНСК: " Lisichansk "
  ЛИТИН: " Litin "
  ЛИХОСЛАВЛЬ: " Likhoslavl "
  ЛОГОЙСК: " Logoysk "
  ? "ЛОДЕЙНОЕ ПОЛЕ"
  : " Listvianka "
  ЛОЕВ: " Loew "
  ЛОЗОВАЯ: " LOZOVAYA "
  ЛОКАЧИ: " Lokachi "
  ЛОКНЯ: " fiber "
  ЛОКОТЬ: " ELBOW "
  ЛОМОНОСОВ: " Lomonosov "
  ЛОПАТИНО: " LOPATIN "
  ЛОПУХИНКА: " Lopukhinka "
  ЛОТОШИНО: " Lotoshino "
  ? "ЛОУХИ КАЛЕВАЛА"
  : " Louhi KALEVALA "
  ЛОХВИЦА: " Lokhvitsya "
  ЛУБНЫ: " Lubni "
  ЛУГА: " MEADOWS "
  ЛУГАНСК: " Lugansk "
  ЛУГИНЫ: " Lugini "
  ЛУГОВОЕ: " MEADOW "
  ЛУДЗА: " Ludza "
  ЛУНИНЕЦ: " LUNINETS "
  ЛУНИНО: " Lunin"
  ЛУТУГИНО: "Lutugino "
  ЛУХОВИЦЫ: " Lukhovitsy "
  ЛУЦК: " Lutsk "
  ЛУЧЕГОРСК: " Luchegorsk "
  ЛЫСКОВО: " Łyskava "
  ? "ЛЫСЫЕ ГОРЫ"
  : " Bald Hills "
  ЛЫСЬВА: " Lys&#39;va "
  ЛЫСЯНКА: " Lysyanka "
  ЛЬВОВ: " Lviv "
  ЛЬГОВ: " Lgov "
  ЛЮБАНЬ-МИНСК: " Luban, Minsk "
  ЛЮБАНЬ-ТОСНО: " Luban-Tosno "
  ЛЮБАР: " Lyubar "
  ЛЮБАШЕВКА: " Lyubashevka "
  ЛЮБЕШОВ: " Lyubeshev "
  ЛЮБИНСКИЙ: " Lyubinskaya "
  ЛЮБОМЛЬ: " Lyuboml "
  ЛЮБЫТИНО: " LYUBYTINO "
  ЛЮДИНОВО: " Lyudinovo "
  ЛЯМБИРЬ: " LYAMBIR "
  ЛЯХОВИЧИ: " LYAKHOVICH "
  МАГАДАН: " MAGADAN "
  МАГАН: " MAGICIAN "
  МАГДАГАЧИ: " Magdagachi "
  МАГДАЛИНОВКА: " Magdalinivka"
  МАГНИТОГОРСК: "MAGNITOGORSK "
  МАДОНА: " MADONNA "
  МАЖЕЙКЯЙ: " Mazeikiai "
  МАЙКАИН: " MAYKAIN "
  МАЙКОП: " MAYKOP "
  МАЙЛИСАЙ: " MAYLISAY "
  МАЙМА: " MAYMA "
  МАЙНА: " MAIN "
  МАЙСКОЕ: " MAYSKIY "
  МАЙЯ: " MAYA "
  МАКАНЧИ: " Makanchi "
  МАКАРОВ: " Makarov "
  МАКАРЬЕВ: " Makarov "
  МАКЕЕВКА: " MAKIYIVKA "
  МАКИНСК: " Makinsk "
  МАКСАТИХА: " Maksatiha "
  МАКСИМОВКА: " Maksimovka "
  МАКУШИНО: " Makushin "
  ? "МАЛАЯ ВИШЕРА"
  : " Malaya Vishera "
  ? "МАЛАЯ ПУРГА"
  : " SMALL SCP "
  ? "МАЛАЯ СЕРДОБА"
  : " SMALL SERDOBA "
  МАЛГОБЕК: " Malgobek "
  МАЛИН: " MALIN "
  МАЛМЫЖ: " Malmyz "
  МАЛОАРХАНГЕЛЬСК: " Maloarkhangelsk"
  МАЛОРИТА: "Malaryta "
  МАЛОЯРОСЛАВЕЦ: " Maloyaroslavetz "
  МАМАДЫШ: " Mamadysh "
  МАМЛЮТКА: " Mamlyutka "
  МАМОНОВО: " Mamonovo "
  МАМОНТОВО: " Mamontov "
  МАНГИТ: " Manga "
  МАНЕВИЧИ: " Manevichi "
  МАНТУРОВО: " Manturova "
  МАНЬКОВКА: " Mankovka "
  МАРАЛИК: " Maralik "
  МАРГАНЕЦ: " Manganese "
  МАРГИЛАН: " Margilan "
  МАРГУШИ: " Margush "
  МАРИ-ТУРЕК: " Maries TUREK "
  МАРИИНСК: " MARIININSKY "
  ? "МАРИЙСКИЙ ПОСАД"
  : " MARI Posad "
  МАРИНОВКА: " Marinivka "
  МАРИУПОЛЬ: " Mariupol "
  МАРИЯМПОЛЕ: " Marijampole "
  МАРКОВКА: " Markovka "
  МАРКС: " MARKS "
  МАРНЕУЛИ: " Marneuli "
  МАРТУК: " MARTUK "
  МАРТУНИ: " MARTUNI"
  МАРХАМАТ: "Markhamat "
  МАРЫ: " MARY "
  ? "МАРЬИНА ГОРКА"
  : " Maryina HILL "
  МАРЬИНКА: " Marinka "
  МАРЬЯНОВКА: " Marianivka "
  МАСИС: " MASIS "
  МАСЛЯНИНО: " MASLYANINO "
  МАССАЛЫ: " Masalis "
  ? "МАТВЕЕВ КУРГАН"
  : " Matveev Kurgan "
  МАХАЧКАЛА: " MAKHACHKALA "
  МАШЕВКА: " Mashivka "
  МГЛИН: " Mglin "
  МЕДВЕЖЬЕГОРСК: " Medvezhyegorsk "
  МЕДВЕНКА: " MEDVENKA "
  МЕДНОГОРСК: " Mednogorsk "
  МЕДЫНЬ: " Medyn "
  МЕЖГОРЬЕ: " Mezhgore "
  МЕЖДУРЕЧЕНСК: " Mezhdurechensk "
  МЕЖЕВАЯ: " Megeve "
  МЕЛЕНКИ: " Melenki "
  МЕЛЕУЗ: " Meleuz "
  МЕЛИТОПОЛЬ: " Melitopol "
  МЕЛОВОЕ: " CRETACEOUS "
  МЕЛЬНИК-ПРИОЗЕР: " Melnik - Lakeshire "
  ? "МЕЛЬНИКОВО ТОМ"
  : " MELNIKOVA VOLUME"
  МЕНА: "MENA "
  МЕНДЕЛЕЕВСК: " Mendeleevsk "
  МЕНЗЕЛИНСК: " Menzelinsk "
  МЕРКЕ: " MERCK "
  МЕРНОГОРСК: " MERNOGORSK "
  МЕСЯГУТОВО: " MESYAGUTOVO "
  МЕЩОВСК: " Meshchovsk "
  МИАСКОЕ: " MIASKOE "
  МИАСС-УРАЛАВТОЗ: " MIASS-URALAVTOZ "
  МИАСС-ЧЕЛЯБИНСК: " MIASS-Chelyabinsk "
  МИАССКОЕ: " MIASS "
  МИГИРИН: " MIGIRIN "
  МИЛЛЕРОВО: " Millerovo "
  МИЛЬКОВО: " Milkovo "
  МИЛЮТИНСКАЯ: " Milyutinskij "
  МИНВОДЫ: " MinVody "
  МИНГЕЧАУР: " Mingechaur "
  МИНСК: " Minsk "
  МИНУСИНСК: " Minusinsk "
  МИОРЫ: " IIED "
  МИРГОРОД: " MIRGOROD "
  МИРНЫЙ: " PEACE "
  МИРОНОВКА: " Mironovka "
  МИХАЙЛОВ: " Mikhailov "
  МИХАЙЛОВКА: " Mikhajlovka"
  МИЧУРИНСК: "MICHURIN "
  МИШКИНО: " Mishkin "
  МЛИНОВ: " MLÝN "
  МОГИЛЕВ: " Mogilev "
  ? "МОГИЛЕВСК ПОД"
  : " Mogilev UNDER "
  МОЖАЙСК: " Mojaisk "
  МОЖГА: " Mozhga "
  МОЗДОК: " Mozdok "
  МОЗЫРЬ: " Mozyr "
  МОКРОУС: " Mokrousov "
  МОКРОУСОВО: " Mokrousov "
  МОКШАН: " Mokshan "
  МОЛЕТАЙ: " Moletai "
  МОЛОДЕЖНОЕ: " Youth "
  МОЛОДЕЧНО: " MOLODECHNO "
  МОЛЧАНОВО: " MOLCHANOVA "
  МОНАСТЫРИСКА: " Monasturisk "
  МОНАСТЫРИЩЕ: " Monastyrische "
  МОНАСТЫРЩИНА: " Monastyrshchina "
  МОНЧЕГОРСК: " Monchegorsk "
  МОРГАУШИ: " Morgaushi "
  МОРДОВО: " MORDOVIA "
  МОРКИ: " DIMA "
  МОРОЗОВСК: " Morozovsk "
  МОРШАНСК: " Morshansk"
  МОСАЛЬСК: "Mosalskiy "
  МОСКАЛЕНКИ: " MOSKALENKO "
  МОСКВА: " MOSCOW "
  МОСКОВСКИЙ: " MOSCOW "
  МОСТИСКА: " Mostiska "
  МОСТОВСКОЕ: " Masty "
  МОСТЫ: " Bridges "
  МОШЕНСКОЕ: " Moshensky "
  МОШКОВО: " Moshkova "
  МРАКОВО: " MRAKOVO "
  МСТИСЛАВЛЬ: " Amścisłaŭ "
  МУБАРЕК: " Mubarek "
  МУЕЗЕРСКИЙ: " Muezersky "
  МУКАЧЕВО: " MUKACHEVO "
  МУРМАНСК: " Murmansk "
  МУРМАНСК-130: " Murmansk-130 "
  ? "МУРОВ КУРИЛОВЦЫ"
  : " Murov Kurilovcy "
  МУРОМ: " Murom "
  МУРОМЦЕВО: " Muromtseva "
  МУСЛЮМОВО: " Muslyumovo "
  МУХОРШИБИРЬ: " MUHORSHIBIR "
  МУЧКАПСКИЙ: " MUCHKAPSKY "
  МЦЕНСК: " Mtsensk "
  МЫСКИ: " Myski "
  МЯДЕЛЬ: " Ãiadel"
  Н-АКМЯНЕ: "H Akmene "
  Н-АЛТАЙСК: " H ALTAISK "
  Н-ИНГАШ: " H INGASH "
  Н-НИКОЛАЕВКА: " H Nikolaevka "
  Н-ШУЛЬБА: " H Shulba "
  ? "НАБЕРЕЖ ЧЕЛНЫ"
  : " embankments CHELNY "
  НАВАШИНО: " NAVASHINO "
  НАВЛЯ: " Navlya "
  НАВОИ: " NAVOI "
  НАДВОРНАЯ: " Nadvornaya "
  НАДТЕРЕЧНАЯ: " Nadterechny "
  НАДЫМ: " NADYM "
  НАЗАРОВО: " NAZAROVA "
  НАЗРАНЬ: " Nazran "
  НАЗЫВАЕВСК: " Nazyvaevsk "
  НАЛЬЧИК: " NALCHIK "
  НАМАНГАН: " Namangan "
  НАМЦЫ: " Namtso "
  НАРВА: " NARVA "
  НАРИМАНОВ: " Narimanov "
  НАРИМАНОВКА: " NARIMANOVKA "
  НАРИМАНОВО: " Narimanov "
  НАРО-ФОМИНСК: " Narofominsk "
  НАРОВЛЯ: " Narovlia "
  НАРОВЧАТ: " Narovchatov"
  НАРОДИЧИ: "Narodichi "
  НАРОЧЬ: " VECTOR "
  НАРТКАЛА: " Nartkala "
  НАРЫН: " NARYN "
  НАРЫНКА: " NARYNKA "
  НАРЫШКИНО: " NARYSHKIN "
  НАУРСКИЙ: " Naurskaya "
  НАФТАЛАН: " NAFTALAN "
  НАХИЧЕВАНЬ: " Nakhchivan "
  НАХОДКА: " FIND "
  НАЧАЛОВО: " Nachalova "
  НЕБИТ-ДАГ: " Nebit DAG "
  НЕВЕЛЬ: " Nevel "
  НЕВЕЛЬСК: " Nevelsk "
  НЕВЕРКИНО: " NEVERKINO "
  НЕВИННОМЫССК: " Nevinnomysk "
  НЕВЬЯНСК: " Nev&#39;jansk "
  НЕДРИГАЙЛОВО: " NEDRIGAYLOVO "
  НЕЖИН: " Nizhin "
  НЕКРАСОВСКОЕ: " Nekrasovskij "
  НЕЛИДОВО: " Nelidovo "
  НЕМА: " HEMA "
  НЕМАН: " NEMAN "
  НЕМИРОВ: " Nemirov "
  НЕРЕХТА: " Nerekhta"
  НЕРЧИНСК: "Nerchinsk "
  НЕРЮНГРИ: " Nerungri "
  НЕСВИЖ: " Shults "
  НЕСТЕРОВ: " NESTEROV "
  НЕФТЕГОРСК: " Neftegorsk "
  НЕФТЕКАМСК: " Neftekamsk "
  НЕФТЕКУМСК: " Neftekumsk "
  НЕФТЕЧАЛА: " Neftchala "
  НЕФТЕЮГАНСК: " Nefteyugansk "
  НЕХАЕВСКИЙ: " NEHAEVSKY "
  НИБРАЙ: " NIBRAY "
  НИДА: " NIDA "
  ? "НИЖНАЯ ОМКА"
  : " Lower OMKA "
  НИЖНЕВАРТОВСК: " Nizhnevartovsk "
  НИЖНЕГОРСКИЙ: " Nizhnogirskiy "
  НИЖНЕДЕВИЦК: " NIZHNEDEVITSK "
  НИЖНЕКАМСК: " Nizhnekamsk "
  ? "НИЖНИЕ СЕРЕГОЗЫ"
  : " Lower SEREGOZY "
  ? "НИЖНИЙ ЛОМОВ"
  : " Nizhniy Lomov "
  ? "НИЖНИЙ СЕРГИ"
  : " Lower SERGO "
  ? "НИЖНИЙ ТАГИЛ"
  : " Nizhniy Tagil "
  ? "НИЖНИЙ ТУРА"
  : " Lower TOUR "
  ? "НИЖНЯЯ ТАВДА"
  : " Lower Tavda "
  НИЗИНО: " Lowland "
  НИКИТИНКА: " NIKITINKA"
  НИКОЛАЕВ: "Nikolaev "
  НИКОЛАЕВ-ЛЬВОВ: " Mykolaiv, Lviv "
  НИКОЛАЕВКА: " Nikolaevka "
  НИКОЛАЕВСК: " MYKOLAYIV "
  НИКОЛАЕВСК-АМУР: " Nikolaevsk-AMUR "
  НИКОЛАЕВЩИНА: " Mykolayiv "
  НИКОЛЬСК-ВОЛОГД: " Nicolskoye-Vologda "
  НИКОЛЬСК-ПЕНЗА: " CHURCH-Penza "
  НИКОЛЬСКИЙ: " CHURCH "
  НИКОЛЬСКОЕ: " CHURCH "
  НИКОПОЛЬ: " NIKOPOL "
  НИСПОРЕНЫ: " NISPORENI "
  НОВАННИНСКИЙ: " NOVANNINSKY "
  ? "НОВАЯ ВОДОЛАГА"
  : " NEW Vodolaga "
  ? "НОВАЯ КАХОВКА"
  : " New Kahovka "
  ? "НОВАЯ ЛАДОГА"
  : " NEW LADOGA "
  ? "НОВАЯ МАЛЫКЛА"
  : " NEW Malykla "
  ? "НОВАЯ ОДЕССА"
  : " New Odessa "
  ? "НОВАЯ УСМАНЬ"
  : " NEW Usmanov "
  ? "НОВАЯ УШИЦА"
  : " NEW Ushitsya "
  НОВГОРОД: " Novgorod "
  НОВГОРОД-СЕВЕРС: " Novgorod-SEVERS "
  НОВГОРОДКА: " Novgorodka "
  НОВГОРОДСКОЕ: " NOVGOROD "
  НОВИНКА: " NEW"
  НОВИЧИХА: "NOVICHIHA "
  НОВО-АЛЕКСАНДР: " NOVO-ALEXANDER "
  НОВО-ВОРОНЕЖСК: " Novo-Voronezh "
  НОВОАЗОВСК: " Novoazovsk "
  НОВОАЙДАР: " Novoaydar "
  НОВОАЛЕКСАНДРОВ: " NOVOALEKSANDROV "
  НОВОАЛЕКСЕЕВКА: " Novooleksiyivka "
  НОВОАЛТАЙСК: " Novoaltaysk "
  НОВОАРХАНГЕЛЬСК: " Novoarhangelsk "
  НОВОБИРИЛЮССЫ: " NOVOBIRILYUSSY "
  НОВОВАРШАВКА: " NOVOVARSHAVKA "
  НОВОВОЛЫНСК: " Novovolinsk "
  НОВОВОРОНЦОВКА: " Novovoroncovka "
  НОВОВЯТСК-КИРОВ: " NOVOVYATSK-Kirov "
  НОВОГРАД-ВОЛЫНС: " Novograd-VOLYNS "
  НОВОГРУДОК: " Navahradak "
  НОВОДУГИНО: " Novodugino "
  НОВОЕГОРЬЕВСКОЕ: " NOVOEGOREVSKOE "
  НОВОЗЫБКОВ: " Novozybkov "
  НОВОКИЕВ-УВАЛ: " Novokom-Uval "
  НОВОКУБАНСК: " Novokubansk "
  НОВОКУЗНЕЦК: " Novokuznetsk "
  НОВОКУЙБЫШЕВСК: " Novokujbyshevsk "
  НОВОЛИСИНО: " Novolisino "
  НОВОМИРГОРОД: " Novomirgorod"
  НОВОМОСКОВСК: "Novomoskovsk "
  НОВОНИКОЛАЕВКА: " Novonikolaevka "
  НОВОНИКОЛАЕВСКИ: " Novonikolayevsk "
  НОВОПАВЛОВСК: " Novopavlovsky "
  НОВОПОКРОВКА: " Novopokrovka "
  НОВОПОКРОВСКАЯ: " Novopokrovsky "
  НОВОПОЛОЦК: " NOVOPOLOTSK "
  НОВОПСКОВ: " Novopskov "
  НОВОРЖЕВ: " Novorzhev "
  НОВОРОССИЙСК: " Novorossiysk "
  НОВОСЕЛИЦА: " Novoselitsya "
  НОВОСЕЛИЦКОЕ: " NOVOSELITSKOE "
  НОВОСЕЛОВО: " NOVOSELOVA "
  НОВОСЕРГИЕВКА: " Novosergievka "
  НОВОСИБИРСК: " Novosibirsk "
  НОВОСИЛЬ: " Novosil "
  НОВОСОКОЛЬНИКИ: " Novosokolniki "
  НОВОСПАССКОЕ: " Novospasskij "
  НОВОТРОИЦК: " Novotroick "
  НОВОТРОИЦКОЕ: " Novotroickoe "
  НОВОУЗЕНСК: " Novouzensk "
  НОВОУКРАИНКА: " Novoukrayinka "
  НОВОХОПЕРСК: " Novokhopersk "
  НОВОЧЕРКАССК: " NOVOCHERKASSK "
  НОВОШАХТИНСК: " Novoshakhtinsk"
  НОВОЯКЕНТ: "NOVOYAKENT "
  ? "НОВЫЕ АНЕНЫ"
  : " OTACI "
  ? "НОВЫЕ БУРАСЫ"
  : " NEW Buras "
  ? "НОВЫЕ САНЖАРЫ"
  : " NEW Sanjar "
  ? "НОВЫЙ БУЧ"
  : " NEW Buch "
  ? "НОВЫЙ ОСКОЛ"
  : " Bangalore "
  ? "НОВЫЙ РАЗДОЛ"
  : " NEW Razdol "
  ? "НОВЫЙ ТОРЬЯЛ"
  : " NEW TORYAL "
  ? "НОВЫЙ УРЕНГОЙ"
  : " NEW URENGOY "
  НОГИНСК: " Noginsk "
  НОГЛИКИ: " NOGLIKI "
  НОЕМБЕРЯН: " Noyemberyan "
  НОЖАЙ-ЮРТ: " Nozhai-Yurt "
  НОЛИНСК: " Nolinsk "
  НОСОВКА: " Nosovka "
  НОЯБРЬСК: " NOVEMBER "
  НУКУС: " Nukus "
  НУРАТА: " Nurata "
  НУРЕК3: " NUREK3 "
  НУРЛАТ: " Nurlat "
  НУРМА: " Nurmi, "
  НЫТВА: " Nytva, "
  НЮКСЕНИЦА: " Niuksenitsa "
  НЮРБА: " Nyurba "
  НЯЗЕПЕТРОВСК: " Nyazepetrovsk"
  НЯНДОМА: "Niandoma "
  ОБИКИИК: " OBIKIIK "
  ОБЛУЧЬЕ: " Obluche "
  ОБНИНСК: " Obninsk "
  ОБОЯНЬ: " Oboyan "
  ОБУХОВ: " OBUKHOV "
  ОБЬЯЧЕВО: " OBYACHEVO "
  ОВИДИОПОЛЬ: " Ovidiopol "
  ОВРУЧ: " Ovruch "
  ОГРЕ: " OGRE "
  ОДЕССА: " Odessa "
  ОДЕССКОЕ: " Odessa "
  ОДОЕВ: " ODOEV "
  ОЗЕРСК: " Ozersk "
  ОЗЕРЫ: " Lakes "
  ОЗИНКИ: " Ozinki "
  ОКНИЦА: " OCNITA "
  ОКОНЕШНИКОВО: " Okoneshnikova "
  ОКТЕМБЕРЯН: " Hoktemberyan "
  ОКТЯБР-ВОЛГОГР: " October-VOLGOGR "
  ОКТЯБРЬСК-АКТЮБ: " Oct-Aktjuba "
  ОКТЯБРЬСК-ГОМ: " Oct-GOM "
  ОКТЯБРЬСК-КУЙБ: " Oct-KUYB "
  ОКТЯБРЬСК-ПЕРМЬ: " Oct-PERM "
  ОКТЯБРЬСК-ТАШАУ: " Oct-Tasha"
  ОКТЯБРЬСКИЙ: "OCTOBER "
  ОКТЯБРЬСКОЕ-ОРД: " Oct-DDS "
  ОКТЯБРЬСКОЕ-ТЮМ: " Oct-Tumen "
  ОКТЯБРЬСКОЕ-ЧЕЛ: " Oct-PERS "
  ОКУЛОВКА: " Okulovka "
  ОЛЕВСК: " Olevsk "
  ОЛЕКМИНСК: " OLYEKMINSKY "
  ОЛЕНЕГОРСК: " Olenegorsk "
  ОЛЕНИНО: " Olenin "
  ОЛЕНОВКА: " OLENOVKA "
  ОЛОНЕЦ: " Olonec "
  ОЛЬГА: " OLGA "
  ОЛЬХОВАТКА: " Olkhovatka "
  ОЛЬХОВКА: " Olkhovka "
  ОЛЬШАНКА: " Olshanka "
  ОМСК: " DHBs "
  ОМСУКЧАН: " Omsukchana "
  ОМУТИНСКИЙ: " OMUTINSKY "
  ОМУТНИНСК: " Omutninsk "
  ОНГУДАЙ: " Ongudaj "
  ОНЕГА: " ONEGA "
  ОНУФРИЕВКА: " Onufriyivka "
  ОПОЧКА: " Opochka "
  ОРАТОВ: " Orativ "
  ОРГЕЕВ: " vechi"
  ОРДА: "ORDA "
  ОРДЖОНИКИДЗЕ: " ORDZHONIKIDZE "
  ОРДЖОНИКИДЗЕВСК: " Ordzhonikidzevsky "
  ОРДЫНСК: " Orda "
  ОРЕЛ: " EAGLE "
  ОРЕНБУРГ: " Orenburg "
  ОРЕХОВ: " Nuts "
  ОРЕХОВО-ЗУЕВО: " OREKHOVO-ZUEVO "
  ОРЖИЦА: " Orzhica "
  ОРИЧИ: " Oric "
  ОРЛОВСКИЙ: " Oryol "
  ОРОТУКАН: " OROTUKAN "
  ОРСК: " Orsk "
  ОРША: " Orsha "
  ОРШАНКА: " Orshanka "
  ОСАКАРОВКА: " OSAKAROVKA "
  ОСИННИКИ: " Osinniki "
  ОСИПОВИЧИ: " OSIPOVICH "
  ОССОРА: " Ossorio "
  ОСТАШКОВО: " Ostashkov "
  ОСТРОВ: " ISLAND "
  ОСТРОВЕЦ: " Astraviec "
  ОСТРОВСКОЕ: " Ostrovsky "
  ОСТРОГ: " OSTROG "
  ОСТРОГОЖСК: " Ostrogozhsk"
  ОТРАДНАЯ: "Gratifying "
  ОТРАДНОЕ-ВЫБОРГ: " gratifying-Vyborg "
  ОТРАДНОЕ-КИРОВ: " gratifying-Kirov "
  ОТРАДНЫЙ: " gratifying "
  ОХАНСК: " Okhansk "
  ОЧАКОВ: " OCHAKOV "
  ОЧЕР: " Ocher "
  ОШМЯНЫ: " Oshmyan "
  ПАВИНО: " Pavin "
  ? "ПАВЛОВ ПОСАД"
  : " Pavlov Posad "
  ПАВЛОВО: " Pavlova "
  ПАВЛОВСК-БАРНАУ: " Pavlovsk-BARNALA "
  ПАВЛОВСК-ВОРОН: " Pavlovsk-CROW "
  ПАВЛОВСКАЯ: " PAVLOVSKAYA "
  ПАВЛОГРАД: " PAVLOGRAD "
  ПАВЛОГРАДКА: " PAVLOGRADKA "
  ПАВЛОДАР: " ALMATY "
  ПАЙДЕ: " PAID "
  ПАЙТУГ: " Paytug "
  ПАЙШАНБА: " Payshanba "
  ПАКРУОЙИС: " PAKRUOYIS "
  ПАЛАНА: " Palau "
  ПАЛАНГА: " Palanga "
  ПАЛАТКА: " tents "
  ПАЛЕХ: " PALEKH"
  ПАЛКИНО: "Palkin "
  ПАЛЛАСОВКА: " Pallasovka "
  ПАНЕВЕЖИС: " Panevezys "
  ПАНИНО: " PANIN "
  ПАНКРУШИХА: " PANKRUSHIHA "
  ПАНФИЛОВ: " PANFILOV "
  ПАРАБЕЛЬ: " Parabel "
  ПАРАНЬГА: " PARANGA "
  ПАРКЕНТ: " Parkent "
  ПАРТИЗАНСК: " GUERRILLA "
  ПАРТИЗАНСКОЕ: " GUERRILLA "
  ПАРФЕНЬЕВО: " Parfen&#39;eva "
  ПАРФИНО: " Paraffin "
  ПАРХАР: " Parkhar "
  ПАСВАЛИС: " Pasvalys "
  ПАХТААБАД-АНДЖ: " Pakhtaabad-ANDRZEJ "
  ПАХТААБАД-ГУЛ: " Pakhtaabad-hum "
  ПАХТАКОР: " Pakhtakor "
  ПАЧЕЛМА: " Pachelma "
  ПАША: " PASHA "
  ПАШКАНЫ: " PASHKANY "
  ПЕКЕНТ: " PEKENT "
  ПЕКИЛАЕВО: " PEKILAEVO "
  ПЕНДЖИКЕНТ: " Pendjikent "
  ПЕНЗА: " Penza"
  ПЕНО: "Peno "
  ПЕРВОМАЙСК: " PERVOMAYSKAYA "
  ПЕРВОМАЙСКОЕ: " PERVOMAYSKAYA "
  ПЕРВОУРАЛЬСК: " PERVOURALSKY "
  ПЕРЕВАЛЬСК: " Perevalsk "
  ПЕРЕВОЛОЦКИЙ: " Perevolotskaya "
  ПЕРЕЛЮБ: " PERELYUB "
  ПЕРЕМЕТНОЕ: " Peremetnoe "
  ПЕРЕМЫШЛЬ: " Przemysl "
  ПЕРЕМЫШЛЯНЫ: " Peremishlyani "
  ПЕРЕСЛАВЛЬ-ЗАЛ: " Pereslavl-HALL "
  ПЕРЕЧИН: " Perechin "
  ПЕРЕЯСЛАВКА: " Pereyaslavka "
  ПЕРЕЯСЛАВЛЬ: " Pereyaslavl "
  ПЕРМЬ: " Perm "
  ПЕРМЬ-76: " Perm-76 "
  ПЕРОВО: " PEROVA "
  ПЕРШОТРАВИНСК: " PERSHOTRAVINSK "
  ПЕРШОТРАВНЕВОЕ: " Pershotravneve "
  ПЕРШОТРАВНОЕ: " PERSHOTRAVNOE "
  ПЕСТОВО: " PESTOVO "
  ПЕСТРИЦЫ: " PESTRITSY "
  ПЕСЧАНКА: " gerbil "
  ПЕСЧАНОКОПСКОЕ: " PESCHANOKOPSKOE "
  ПЕТИЛИНО: " PETILINO"
  ПЕТРИКОВ: "PETRIKOV "
  ПЕТРОВО: " Petrova "
  ПЕТРОВСК: " PETROVSKY "
  ПЕТРОВСКОЕ: " PETER "
  ПЕТРОЗАВОДСК: " Petrozavodsk "
  ПЕТРОПАВЛОВКА: " Petropavlivka "
  ПЕТРОПАВЛОВСК: " Petropavlovsk "
  ПЕТРОПАВЛОВСКОЕ: " Petropavlovsk "
  ПЕТУХОВО: " Petukhova "
  ПЕТУШКИ: " Petushki "
  ПЕЧОРА: " Pechory "
  ПЕЧОРЫ: " Pechory "
  ПИЛЬНА: " Pilna "
  ПИНСК: " Pinsk "
  ПИОНЕРСК: " ПИОНЕРСК "
  ПИРОВСКОЕ: " PIROVSKOE "
  ПИРЯТИН: " Piryatin "
  ПИТЕРКА: " PITERKA "
  ПИТКЯРАНТА: " Pitkyaranta "
  ПЛАВСК: " Plavsk "
  ПЛАСТ: " Plast "
  ПЛЕШАНОВО: " PLESHANOVA "
  ПЛУНГЕ: " Plunge "
  ПЛЮССА: " Plyussa "
  ПОБЕДА: " VICTORY"
  ПОВОРИНО: "Povorino "
  ПОГАР: " POGAR "
  ПОГРАНИЧНЫЙ: " BORDER "
  ПОГРЕБИЩЕ: " Pogrebishche "
  ПОДВОЛОЧИНСК: " PODVOLOCHINSK "
  ПОДГОРЕНСКИЙ: " PODGORENSKY "
  ПОДДОРЬЕ: " PODDORE "
  ПОДОЛЬСК: " PODOLSK "
  ПОДПОРОЖЬЕ: " Podporozhye "
  ПОКРОВ: " COVER "
  ПОКРОВКА: " Pokrovka "
  ПОКРОВСК: " POKROVSKAYA "
  ПОКРОВСКОЕ: " POKROVSKOE "
  ПОЛЕВСКОЙ: " Polevskoy "
  ПОЛЕССК: " Polessk "
  ПОЛЕССКОЕ: " Polessk "
  ПОЛОВИННОЕ: " HALF "
  ПОЛОГИ: " CANOPY "
  ПОЛОННОЕ: " FULL "
  ПОЛОЦК: " POLOTSK "
  ПОЛТАВА: " Poltava "
  ПОЛТАВКА: " Poltavka "
  ПОЛЯРНЫЙ: " polarity "
  ПОМЕРАНЬЕ: " Pomerania "
  ПОНАЗЫРЕВО: " Ponazyrevo"
  ПОНЫРИ: "PONYRI "
  ПОПАСНАЯ: " Popasna "
  ПОПЕЛЬНЯ: " Popelnya "
  ПОРЕЦКОЕ: " Poreckij "
  ПОРОНАЙСК: " Poronajsk "
  ПОРХОВ: " fluttering "
  ПОРЫГИНО: " PORYGINO "
  ПОС-ИМ-МОРОЗОВА: " POS-IM-MOROZOVA "
  ПОСЕЛОК-ТЕЛЬМАН: " VILLAGE-TELMAN "
  ПОСПЕЛИХА: " Pospelikha "
  ПОСТАВЫ: " Placing "
  ПОТАНИНО: " POTANIN "
  ПОТИ: " Poti "
  ПОХВИСТНЕВО: " Pokhvistnevo "
  ПОЧЕП: " Pochep "
  ПОЧИНКИ: " REPAIR "
  ПОЧИНОК: " repairs "
  ПОША: " POSHA "
  ПРАВДИНСК: " Pravdinsk "
  ПРЕЙЛИ: " Preili "
  ПРЕНАЙ: " Prienai "
  ПРЕСНОВКА: " Presnovka "
  ПРЖЕВАЛЬСК: " Przhevalsk "
  ПРИАЗОВСКОЕ: " Priazovske "
  ПРИАРГУНСК: " Priargunskoe"
  ПРИВОЛЖСК: "PRIVOLZHSKAYA "
  ПРИЛУКИ: " PRILUKI "
  ПРИМ-АХТАРСК: " PRIM-Akhtarsk "
  ПРИМ-ВЫБОРГ: " PRIM-Vyborg "
  ПРИМ-ЗАПОРОЖЬЕ: " PRIM-ZAPOROZHYE "
  ПРИОЗЕРСК: " Priosersk "
  ПРИПЯТЬ: " Pripyat "
  ПРИСТЕНЬ: " Wall "
  ПРИЮТНОЕ: " Priyutnoe "
  ПРОКОПЬЕВСК: " Prokopevsk "
  ПРОЛЕТАРСК: " PROLETARIAN "
  ПРОМЫШЛЕННОЕ: " INDUSTRIAL "
  ПРОХЛАДНЫЙ: " Cool "
  ПРОХОРОВКА: " Prokhorovka "
  ПРОЧЕХ: " PROCHEH "
  ПРУЖАНЫ: " ПРУЖАНЫ "
  ПРЯЖА: " Yarn "
  ПРЯМИЦИНО: " PRYAMITSINO "
  ПСКОВ: " Pskov "
  ПУГАЧЕВ: " PUGACHEV "
  ПУДОЖ: " Pudozh "
  ПУДОСТЫ: " PUDOSTY "
  ПУСТОМЫТЫ: " Pustomiti "
  ПУСТОШКА: " barren "
  ПУТИВЛЬ: " Putivl"
  ПУТИЛА: "Putila "
  ПУТЯТИНО: " Putjatin "
  ПУХОВИЧИ: " Puhovichi "
  ПУШКИНО: " Pushkin "
  ПУШКИНСК-ГОРЫ: " Pushkin-MOUNTAINS "
  ПУШНОЕ: " FUR "
  ПЧЕВЖА: " PCHEVZHA "
  ПЫЛВА: " Polva "
  ПЫТАЛОВО: " Pytalovo "
  ПЫЩУЧ: " PYSCHUCH "
  ПЯНДЖ: " Panji "
  ПЯРНУ: " PARNU "
  ПЯТИГОРСК: " PYATIGORSK "
  ПЯТИХВАТКИ: " PYATIHVATKI "
  РАДВИЛИШКИС: " Radviliskis "
  РАДЕХОВ: " Radekhiv "
  РАДИОНОВО-НЕСВ: " Radionova-НЕСВ "
  РАДИЩЕВО: " Radishcheva "
  РАДОМЫШЛЬ: " Radomyshl "
  РАДОФИННИКОВО: " RADOFINNIKOVO "
  РАЗДАН: " HRAZDAN "
  РАЗДЕЛЬНАЯ: " SEPARATE "
  РАЗДОЛЬНОЕ: " Razdolnoe "
  РАЗМЕТЕЛЕВО: " RAZMETELEVO "
  РАЙЧИХИНСК: " Rajchikhinsk"
  РАКВЕРЕ: "RAKVERE "
  РАКИТНОЕ-БЕЛГ: " Rokitne-BELGIUM "
  РАКИТНОЕ-КИЕВ: " Rokitne-KIEV "
  РАКИТНОЕ-РОВНО: " Rokitne-Rivne "
  РАМЕКШИ: " RAMEKSHI "
  РАМЕНСКОЕ: " Ramenskoye "
  РАМОНЬ: " RAMON "
  РАПЛА: " RAPLA "
  РАСЕЙНЯЙ: " Raseiniai "
  РАССКАЗОВО: " Rasskazova "
  РАТНО: " PATH "
  РАХОВ: " Rakhiv "
  РАХЬЯ: " Rahja "
  РЕБРИХА: " REBRIHA "
  РЕВДА: " Revda "
  РЕЗЕКНЕ: " RĒZEKNE "
  РЕЗИНА: " RUBBER "
  РЕМОНТНОЕ: " REPAIR "
  РЕНИ: " Renee "
  РЕПКИ: " BULBS "
  РЕЧИЦА: " RECHITSA "
  РЕШЕТИЛОВКА: " Reshetilovka "
  РЖЕВ: " Rzhev "
  РИГА: " RIGA "
  РИШТАН: " Rishtan"
  РОВЕНЬКИ-БЕЛГ: "Rovenky-BELGIUM "
  РОВЕНЬКИ-ВОРОШ: " Rovenky-Vorosh "
  РОВНО: " Rovno "
  РОВНОЕ: " Rovno "
  РОГАТИН: " Rohatyn "
  РОГАЧОВ: " ROGACHEV "
  РОДИНО: " HOMELAND "
  РОДИНСКОЕ: " RODINSKOE "
  РОДИОНОВО-НЕСВ: " Rodionova-НЕСВ "
  РОДНИКИ: " Rodnik "
  РОЖДЕСТВЕННО: " Nativity "
  РОЖИЩЕ: " Rozhishche "
  РОЖНЯТОВ: " Rozhnyatov "
  РОКИШКИС: " Rokiskis "
  РОМАНОВКА: " Romanovka "
  РОМАНОВО: " ROMANOVA "
  РОМАШКИ: " Daisy "
  РОМИТАН: " Romitan "
  РОМНЫ: " Romney "
  РОМОДАНОВО: " Romodanovo "
  РОСЛАВЛЬ: " Roslavl "
  РОССОНЫ: " Rosson "
  РОССОШЬ: " ROSSOSH "
  РОСТОВ: " Growth "
  РОСТОВ-НА-ДОНУ: " ROSTOV-ON-DON"
  РОЩИНО: "ROSHCHINA "
  РТИЩЕВО: " Rtischevo "
  РУБЕЖНОЕ: " Rubizhne "
  РУБЦОВСК: " RUBTSOVSK "
  РУДНЫЙ: " ORE "
  РУДНЯ-ВОЛГОГР: " PFUR-VOLGOGR "
  РУДНЯ-СМОЛЕНСК: " PFUR-Smolenskaya "
  РУЖИН: " Ruzhin "
  РУЗА: " RUZA "
  РУЗАЕВКА-КОКЧЕТ: " Ruzaevka-KOKCHET "
  РУЗАЕВКА-САРАН: " Ruzaevka-SARAN "
  РУССКАЯ-ПОЛЯНА: " RUSSIAN-FIELD "
  ? "РУССКИЙ КАМЕШКИ"
  : " RUSSIAN Gems "
  РУСТАВИ: " RUSTAVI "
  РЫБЕЖНО: " RYBEZHNO "
  РЫБИНСК: " RYBINSK "
  ? "РЫБНАЯ СЛОБОДА"
  : " FISH SLOBODA "
  РЫБНИЦА: " RIBNITA "
  РЫЛЬСК: " Rylsk "
  РЫШКАНЫ: " Riscani "
  РЯБОВО-ВЫБОРГ: " Ryabov-Vyborg "
  РЯБОВО-ТОСНО: " Ryabov-Tosno "
  РЯЖСК: " Ryazhsk "
  РЯЗАНЬ: " RYAZAN "
  С-ПОКРОВКА: " C-Pokrovka"
  СААТЛЫ: "Saatly "
  САБИРАБАД: " Sabirabad "
  САВИНО: " SAVINO "
  САВРАНЬ: " Savran "
  САКАР: " SAKAR "
  САКИ: " Saki "
  САКМАРА: " Sakmar "
  САЛАВАТ: " Salavat "
  САЛДУС: " Saldus "
  САЛЕХАРД: " SALEKHARD "
  САЛЬСК: " Salsk "
  САЛЬЯНЫ: " Salyan "
  САМАРКАНД: " Samarkand "
  САМАРСКОЕ: " SAMARSKE "
  САМБОР: " Sambor "
  САМОЙЛОВКА: " SAMOYLOVKA "
  САМТРЕДИА: " Samtredia "
  САНАТОРИЙ: " HEALTH "
  САНДОВО: " SANDOVO "
  САПОЖОК: " Sapozhok "
  САРАИ: " SARAN "
  САРАКТАШ: " Saraktash "
  САРАНСК: " Saransk "
  САРАНЬ: " Saran "
  САРАПУЛ: " Sarapul"
  САРАТА: "Saratov "
  САРАТОВ: " Saratov "
  САРБАДА: " SARBADA "
  САРГАТСКОЕ: " Sargatskoe "
  САРКАНД: " Sarķand "
  САРМАНОВО: " Sarmanov "
  САРНЫ: " Sarno "
  САРЫ-ОЗЕК: " Sary-Ozeki "
  САРЫАГАН: " SARYAGAN "
  САСОВО: " Sasovo "
  САТИНКА: " SATINKA "
  САТКА: " SATCOM "
  САФАКУЛЕВО: " SAFAKULEVO "
  САФОНОВО: " SAFONOVA "
  САХНОВШИНА: " SAHNOVSHINA "
  САЯТ: " SAYAT "
  СВАЛЯВА: " Svalyava "
  СВАТОВО: " Svatovo "
  СВЕРДЛОВСК: " SVERDLOVSK "
  СВЕТЛОВОДСК: " Svitlovodsk "
  СВЕТЛОГОРСК: " Svetlogorsk "
  СВЕТЛОГРАД: " SVETLOGRAD "
  СВЕТЛЫЙ: " LIGHT "
  ? "СВЕТЛЫЙ ЯР"
  : " LIGHT DM "
  СВЕТОГОРСК: " Svetogorsky"
  СВИСЛОЧЬ: "SVISLOCH "
  СВОБОДНЫЙ: " FREE "
  СДВИНСК: " SDVINSK "
  СЕБЕЖ: " Sebej "
  СЕВАН: " SEVAN "
  СЕВАСТОПОЛЬ: " Sevastopol "
  СЕВЕРНОЕ: " North "
  СЕВЕРОБАЙКАЛЬСК: " Severobaikalsk "
  СЕВЕРОДВИНСК: " SEVERODVINSK "
  СЕВЕРОДОНЕЦК: " Syeverodonets&#39;k "
  СЕВЕРОМОРСК: " Severomorsk "
  СЕВЕРОУРАЛЬСК: " Severouralsk "
  СЕВЕРСК: " Seversk "
  СЕВЕРСКАЯ: " Siverskiy "
  СЕВСК: " Sevsk "
  СЕГЕЖА: " Segezha "
  СЕЙМЧАН: " Sejmchan "
  СЕЛИДОВО: " Selidovo "
  СЕЛИЖАРОВО: " Selizharovo "
  ? "СЕЛО БАБУШКИНА"
  : " VILLAGE BABUSHKINA "
  СЕЛТЫ: " SELTY "
  СЕЛЬЦО: " Selco "
  СЕМЕНОВ: " Semenov "
  СЕМЕНОВКА: " Semenovka "
  СЕМИКАРАКОРСК: " Semikarakorsk"
  СЕМИОЗЕРНОЕ: "Semiozernoe "
  СЕМИПАЛАТИНСК: " SEMIPALATINSK "
  СЕНГИЛЕЙ: " Sengiley "
  СЕННО: " Hay "
  СЕРАФИМОВИЧ: " Serafimovich "
  СЕРГАЧ: " Sergach "
  СЕРГИЕВСК: " Sergievsk "
  СЕРДОБСК: " Serdobsk "
  ? "СЕРЕБРЯН ПРУДЫ"
  : " SEREBRIAN Pond "
  СЕРЕБРЯНСК: " Serebryansk "
  СЕРЕДИНА-БУДА: " MIDDLE-Buda "
  СЕРМОНТОВО: " SERMONTOVO "
  СЕРНУР: " SERNUR "
  СЕРОВ: " SEROV "
  СЕРПУХОВ: " Serpukhov "
  СЕРХОВОЖЬЕ: " SERHOVOZHE "
  СЕРЫШЕВО: " Serysheva "
  СИВА: " SIVA "
  СИВЕРСКАЯ: " Siverskij "
  СИГУЛДА: " SIGULDA "
  СИДЕЛЬНИКОВО: " Sidel&#39;nikova "
  СИЛЛАМЯЭ: " Sillamae "
  СИМФЕРОПОЛЬ: " Simferopol "
  СИНЕГОРЬЕ: " SINEGORYE "
  СИНЕЛЬНИКОВО: " Sinelnikovo"
  СИСИАН: "Sisian "
  СКАДОВСК: " Skadovsk "
  СКВИРА: " Skvira "
  СКОВОРОДИНО: " Skovorodino "
  СКОЛЕ: " SKOL "
  СКОПИН: " Skopin "
  СКУОДАС: " SKUODAS "
  СЛАВГОРОД: " SLAVGOROD "
  СЛАВСК: " Slavskoe "
  СЛАВУТА: " Slavuta "
  СЛАВЯНКА: " SLAVYANKA "
  ? "СЛАВЯНКА ПРИМ."
  : " SLAVYANKA PRIM. "
  СЛАВЯНОГОРСК: " Slavyanogorsk "
  СЛАВЯНОСЕРБСК: " Slavyanoserbsk "
  СЛАВЯНСК: " SLAVIC "
  ? "СЛАВЯНСК КБНЬ"
  : " SLAVIC KBN "
  СЛАНЦЫ: " SHALE "
  СЛОБОДЗЕЯ: " Slobozia "
  СЛОБОДСКОЕ: " SLOBODSKAYA "
  СЛОНИМ: " ELEPHANT "
  СЛУЦК: " SLUTSKAYA "
  СМЕЛА: " Bold "
  СМИДОВИЧИ: " Smidovich "
  СМИРНОВО: " SMIRNOV "
  СМОЛЕВИЧИ: " Smolevichy"
  СМОЛЕНСК: "Smolenskaya "
  СМОЛЕНСКОЕ: " Smolenskaya "
  СМОРГОНЬ: " Smorgon "
  СНЕЖНОЕ: " Snow "
  СНЕЧКУС: " Sniečkus "
  СНИГИРЕВКА: " Snigurivka "
  СНЯТЫН: " Snyatin "
  СОБИНКА: " Sobinka "
  СОБОЛЕВО: " SOBOLEV "
  СОВЕТАБАД: " SOVETABAD "
  СОВЕТСК: " Soviet "
  ? "СОВЕТСК КИРОВ"
  : " Soviet Kirov "
  ? "СОВЕТСКАЯ ГАВАН"
  : " SOVIET HAVANA "
  СОВЕТСКИЙ: " Soviet "
  СОВЕТСКИЙ-БАРН: " Soviet-BARNEY "
  СОВЕТСКИЙ-ВБРГ: " SOVIET-VBRG "
  СОВЕТСКИЙ-ДШНБ: " SOVIET-DSHNB "
  СОВЕТСКИЙ-НЛЬЧК: " SOVIET-NLCHK "
  СОВЕТСКИЙ-СИМФ: " SOVIET-Symphony "
  СОВЕТСКИЙ-ТЮМ: " SOVIET-Tumen "
  СОВЕТСКОЕ: " Soviet "
  ? "СОВХОЗ ИМ УШАЧИ"
  : " State Farm Vušačy "
  СОКАЛЬ: " Sokal "
  СОКИРЯНЫ: " Sokiryani "
  СОКОЛ: " FALCON"
  СОКОЛИНСКОЕ: "Sokolinskii "
  СОКОЛОВКА: " SOKOLOVKA "
  СОКУЛУК: " Sokuluk "
  СОЛДАТСКИЙ: " SOLDIERS "
  СОЛЕНОЕ: " salted "
  СОЛИГАЛИЧ: " Soligalich "
  СОЛИГОРСК: " SOLIGORSK "
  СОЛИКАМСК: " Solikamsk "
  СОЛНЕЧНЫЙ: " SUNNY "
  СОЛНЦЕВО: " Solntseva "
  СОЛОТЧА: " Solotcha "
  СОЛТОН: " Salton "
  СОЛЬ-ИЛЕЦК: " Sol-Iletsk "
  СОЛЬЦЫ: " Soltz "
  СОНКОВО: " Sonkovo "
  СОРОКИ: " FORTY "
  СОРОЧИНСК: " Sorochinsk "
  СОРТАВАЛА: " Ulan Ude "
  СОСНИЦА: " Sosnitsya "
  СОСНОВКА: " Sosnovka "
  СОСНОВО: " PINE "
  СОСНОВО-ОЗЕРСК: " pine-Ozersk "
  СОСНОВОБОРСК: " Sosnovoborsk "
  ? "СОСНОВЫЙ БОР"
  : " ASPEN BOR "
  СОСНОГОРСК: " Sosnogorsk"
  СОФИЕВКА: "Sofiyivka "
  СОЧИ: " Sochi "
  СПАС-ДЕМЕНСК: " SPAS-Demensk "
  СПАС-КЛЕПИКИ: " SPAS-Klepiki "
  СПАССК-ДАЛЬНИЙ: " SPASSKY-FAR "
  СПАССК-РЯЗАНСКИ: " Spassk-Ryazansky "
  СПИРОВО: " Spirovo "
  СПИТАК: " SPITAK "
  СРЕБНОЕ: " Srebnoe "
  ? "СРЕДНЯЯ АХТУБА"
  : " MIDDLE Akhtuba "
  СРЕТЕНСК: " Sretensk "
  СТАВИЩЕ: " Stavishche "
  СТАВРОПОЛЬ: " Stavropol "
  ? "СТАНИЦА АРХАНСК"
  : " Stanitsa ARHANSK "
  СТАНИЧНО-ЛУГАНС: " Stanichno-LUGANS "
  СТАНОВОЕ: " Become "
  ? "СТАРАЯ ВЫЖЕВКА"
  : " OLD Vyzhevka "
  ? "СТАРАЯ МАЙНА"
  : " OLD MAIN "
  ? "СТАРАЯ ПОЛТАВКА"
  : " OLD Poltavka "
  ? "СТАРАЯ РУССА"
  : " Staraya Russa "
  ? "СТАРАЯ СИНЯВА"
  : " OLD Sinyava "
  СТАРИЦА: " Starica "
  СТАРОАЛЕЙСКОЕ: " STAROALEYSKOE "
  СТАРОБЕЛЬСК: " Starobilsk"
  СТАРОБЕШЕВО: "Starobishevo "
  СТАРОДУБ: " Starodub "
  ? "СТАРОЕ ШАЙГОВО"
  : " OLD SHAYGOVO "
  СТАРОЖИЛОВО: " Starozhilov "
  СТАРОКОНСТАНТИН: " Starokostyantiniv "
  СТАРОМИНСКАЯ: " Starominskaya "
  СТАРОЩЕРБИНОВСК: " STAROSCHERBINOVSK "
  СТАРОЮРЬЕВО: " STAROYUREVO "
  ? "СТАРЫЕ ДОРОГИ"
  : " OLD ROADS "
  ? "СТАРЫЙ ОСКОЛ"
  : " Stary Oskol "
  ? "СТАРЫЙ САМБОР"
  : " Old Sambor "
  СТАХАНОВ: " Stakhanov "
  СТЕПАНОВАН: " STEPANOVAN "
  СТЕПАНОКЕРТ: " STEPANOKERT "
  СТЕПНОГОРСК: " Marrickville "
  СТЕПНОЕ: " STEPPE "
  СТЕПНЯК: " Stepniak "
  СТЕРЛИБАШЕВО: " STERLIBASHEVO "
  СТЕРЛИТАМАК: " Sterlitamak "
  СТКУМЫЛЖЕНСКАЯ: " STKUMYLZHENSKAYA "
  СТОЛБЦЫ: " COLUMNS "
  СТОЛИН: " Stolin "
  СТОРОЖИНЕЦ: " Storozhinets "
  СТРАШЕНЫ: " Strasheny "
  СТРЕЖЕВОЙ: " Strezhevoj "
  СТРОЕНИЕ: " STRUCTURE"
  СТРОИТЕЛЬ: "BUILDER "
  ? "СТРУГИ КРАСНЫЕ"
  : " Struga Red "
  СТРЫЙ: " Striy "
  СТУПИНО: " Stupino "
  СТУЧКА: " lv "
  СУВОРОВ: " SUVOROV "
  СУВОРОВО: " SUVOROVA "
  СУДАК: " Sudak "
  СУДЖА: " Sudzha "
  СУДИСЛАВЛЬ: " Sudislavl "
  СУДОГДА: " Sudogda "
  СУЗАК: " Suzak "
  СУЗДАЛЬ: " Suzdal "
  СУЗЕМКА: " Suzemka "
  СУЗУН: " Suzun "
  СУКСУН: " Suksun "
  СУЛЮКТА: " Sulukta "
  СУМГАИТ: " SUMGAIT "
  СУМЫ: " Sumy "
  СУНА: " SUNA "
  СУНТАР: " SUNTAR "
  СУОЯРВИ: " Suojärvi "
  СУРАЖ: " Surazh "
  СУРГУТ: " Surgut "
  СУРОВИКИНО: " Surovikin"
  СУРСКОЕ: "Surskij "
  СУСАНИНО: " SUSANIN "
  СУСУМАН: " Susuman "
  СУХИНИЧИ: " Sukhinichi "
  СУХОБУЗИМСКОЕ: " Sukhobuzimo "
  ? "СУХОЙ ЛОГ"
  : " Sukhoi Log "
  СУХУМИ: " SUKHUMI "
  СЫЗРАНЬ: " Syzran "
  СЫКТЫВКАР: " SYKTYVKAR "
  СЫРДАРЬЯ: " SYRDARYA "
  СЫСЕРТЬ: " Syrset "
  СЫЧЕВКА: " Sychovka "
  СЮМЕИ: " SYUMEI "
  СЯМЖА: " SYAMZHA "
  СЯСЬКЕЛОВО: " SYASKELOVO "
  Т-ЦКАРО: " T-Tskaro "
  ТАБАГО: " Tobago "
  ТАБУНЫ: " herd "
  ТАВДА: " Tavda "
  ТАВРИЧЕСКОЕ: " TAVRICHESKY "
  ? "ТАВРИЧЕСКОЕ ОМК"
  : " TAVRICHESKY OMC "
  ТАГАНРОГ: " Taganrog "
  ТАЗА-БАЗАР: " PELVIC - BAZAAR "
  ТАЗОВСКИЙ: " Tazovskij "
  ТАЙТУГ: " TAYTUG"
  ТАЙШЕТ: "TAYSHET "
  ТАЛАЛАЕВКА: " Talalayivka "
  ТАЛАС: " TALAS "
  ТАЛГАР: " Talgar "
  ТАЛДОМ: " Taldy "
  ТАЛДЫ-КУРГАН: " Taldykorgan "
  ТАЛИН: " Talin "
  ТАЛИЦА: " Talica "
  ТАЛЛИНН: " Tallinn "
  ТАЛОВАЯ: " Talov "
  ТАЛСИ: " TALSI "
  ТАЛШИК: " TALSHIK "
  ТАЛЬМЕНКА: " Talmenka "
  ТАЛЬНОЕ: " Talnoe "
  ТАМАЛА: " TAMA "
  ТАМБОВ: " TAMBOV "
  ТАМДЫБУЛАК: " Tamdibulak "
  ТАРА: " PACKAGES "
  ТАРАКЛИЯ: " Taraclia "
  ТАРАНОВСКОЕ: " Taranovskyy "
  ТАРАША: " TARASHA "
  ТАРБАГАТАЙ: " Tarbagatai "
  ТАРКО-САЛЕ: " Tarko-Sale "
  ТАРТУ: " Tartu "
  ТАРУСА: " TARUS"
  ТАРУТИНО: "Tarutino "
  ТАСТЫ-ТАЛДЫ: " Tasty-Talda "
  ТАТАРБУНАРЫ: " Tatarbunari "
  ТАТАРСК: " Tatar "
  ТАТИЩЕВО: " Tatishcheva "
  ТАУРАГЕ: " Taurage "
  ТАХИАТАШ: " Takhiatash "
  ТАХТА-БАЗАР: " TAKHT-BAZAAR "
  ТАХТААБАД: " TAHTAABAD "
  ТАХТАКУПЫР: " Takhtakupyr "
  ТАШАУЗ: " Dashuz "
  ТАШБУЛАК: " Tashbulak "
  ТАШКЕНТ: " TASHKENT "
  ТАШЛАК: " Tashlak "
  ТАШТАГОЛ: " Tashtagol "
  ТБИЛИСИ: " Tbilisi "
  ТБИЛИССКАЯ: " TBILISI "
  ТЕВРИЗ: " TEVRIZ "
  ТЕДЖЕН: " Tej "
  ТЕЙКОВО: " Teikovo "
  ТЕКЕЛИ: " Tekeli "
  ТЕЛАВИ: " Telavi "
  ТЕЛЕНЕШТЫ: " Telenesti "
  ТЕЛЬМАНОВО: " Telmanove "
  ТЕЛЬМАНСК: " TELMANSK"
  ТЕЛЬШЯЙ: "Telshiai "
  ТЕМИРЛАНОВКА: " Temirlanovka "
  ТЕМИРТАУ: " Temirtau "
  ТЕМКИНО: " Temkin "
  ТЕМРЮК: " Temruk "
  ТЕНЬГУШЕВО: " TENGUSHEVO "
  ТЕОФИПОЛЬ: " Teofipol "
  ТЕПЛИК: " Teplik "
  ТЕПЛОЕ: " WARM "
  ТЕПЛОКЛЮЧЕНКА: " TEPLOKLYUCHENKA "
  ТЕРБУНЫ: " Terbuny "
  ТЕРЕБОВЛЯ: " Terebovlya "
  ТЕРЕК: " TECA "
  ТЕРЕНЬГА: " TERENGA "
  ТЕРМЕЗ: " Termez "
  ТЕРНЕЙ: " TERN "
  ТЕРНОВКА: " Ternovka "
  ТЕРНОПОЛЬ: " Ternopol "
  ТЕРСКОЛ: " Terskol "
  ТЕТИЕВ: " Tetiev "
  ТЕТРИЦКАРО: " Tetritskaro "
  ТЕТЮШИ-ТАТАРС: " Tetyushi-TATARS "
  ТИАНЕТИ: " Tianeti "
  ТИГИЛЬ: " Tigil "
  ТИМАШЕВСК: " Timashevsk"
  ТИМИРЯЗЕВО: "Timiryazeva "
  ТИРАСПОЛЬ: " TIRASPOL "
  ТИСУЛЬ: " Tisul "
  ТИХВИН: " Tikhvin "
  ТИХОРЕЦК: " Tikhoretsk "
  ТЛУМАЧ: " Tlumach "
  ТОБОЛЬСК: " TOBOLSK "
  ТОГУЛ: " TOGUL "
  ТОГУЧИН: " Toguchin "
  ТОЙТЕПА: " Toitepa "
  ТОКАРЕВКА: " Tokarevka "
  ТОКАРИ: " TOKAR "
  ? "ТОКМАК ЗАПОРОЖ"
  : " Tokmak ZAPOROZHYE "
  ? "ТОКМАК ФРУНЗЕ"
  : " Tokmak FRUNZE "
  ТОКСОВО: " Fietsen "
  ТОКТОГУЛ: " Toktogul "
  ТОЛБАЗЫ: " TOLBAZY "
  ТОЛОЧИН: " Tałačyn "
  ТОЛЬЯТТИ: " Tolyatti "
  ТОМАКОВКА: " Tomakivka "
  ТОМАРИ: " Tomar "
  ТОМАШПОЛЬ: " Tomashpil "
  ТОМСК: " Tomsk "
  ТОПАР: " TOPAR "
  ТОПКИ: " FURNACE"
  ТОПЧИХА: "TOPCHIHA "
  ТОРБЕЕВО: " TORBEEVO "
  ТОРЕЗ: " TOREZA "
  ТОРЖОК: " Torzhok "
  ТОРОПЕЦ: " Toropets "
  ТОСНО: " Tosno "
  ТОТЬМА: " Totma "
  ТРАКАЙ: " Trakai "
  ТРОИЦК: " TRINITY "
  ТРОИЦКО-ПЕЧЕРСК: " Trinity-PECHERSK "
  ? "ТРОИЦКОЕ БАРНАУ"
  : " TRINITY BARNALA "
  ? "ТРОИЦКОЕ ВОРОШ"
  : " TRINITY Vorosh "
  ? "ТРОИЦКОЕ ХАБАР"
  : " TRINITY Khabar "
  ТРОИЦКОЕ-КАЛМЫЦ: " Trinity-KALMYTS "
  ТРОСТЯНЕЦ: " Trostyanets "
  ? "ТРУБНИКОВ БОР"
  : " Trubnikov BOR "
  ТРУБЧЕВСК: " Trubchevsk "
  ТРУСКАВЕЦ: " TRUSKAVETS "
  ТУАПСЕ: " TUAPSE "
  ТУКУМС: " TUKUMS "
  ТУЛА: " Tula "
  ТУЛЬЧИН: " Tulchin "
  ТУРАКУРГАН: " Turakurgan "
  ТУРИЙСК: " Turiysk "
  ТУРКА: " TURKU"
  ТУРКЕСТАН: "Turkestan "
  ТУРКИ: " TURKS "
  ТУРКМЕН-КАЛА: " TURKMEN-KALA "
  ТУРСУНЗАДЕ: " Tursunzade "
  ТУРТКУЛЬ: " Turtkul "
  ТУРУНТАЕВО: " Turuntaevo "
  ТУТАЕВ: " Tutaev "
  ТЫВРОВ: " Tivriv "
  ТЫНДА: " Tynda "
  ТЫРНЫАУЗ: " Tyrnyauz "
  ТЫСМЕНИЦА: " Tismenitsya "
  ТЮКАЛИНСК: " Tyukalinsk "
  ТЮМЕНЦЕВО: " Tyumentseva "
  ТЮМЕНЬ: " Tyumen "
  ТЯЧЕВ: " Tyachev "
  УБИНСКОЕ: " Uba "
  УВАРОВО: " UVAROVA "
  УВАТ: " Uvat "
  УВЕЛЬСКИЙ: " UVELSKY "
  УГЛЕГОРСК: " Uglegorsk "
  УГЛИЧ: " Uglich "
  УГЛОВСКОЕ: " Uglovskoe "
  УГРА: " Ugra "
  УДОМЛЯ: " Udomlia "
  УЖГОРОД: " UZHGOROD"
  УЖУР: "Uzhur "
  УЗГЕН: " Uzgen "
  УЗДА: " bridle "
  УЗЛОВАЯ: " UNITS "
  УЗУН: " Uzun "
  УЗУН-АГАЧ: " Uzun-Agach "
  УИНСКОЕ: " UINSKOE "
  УЙСКОЕ: " Ujskij "
  УЙЧИ: " Uychi "
  УКМЕРГЕ: " Ukmergë "
  УЛАН-УДЭ: " Ulan-Ude "
  УЛЕТЫ: " УЛЕТЫ "
  УЛЬЯНОВКА-КИРОВ: " Ulyanovka-Kirov "
  УЛЬЯНОВКА-ТОСНО: " Ulyanovka-Tosno "
  УЛЬЯНОВО: " Ulyanov "
  УЛЬЯНОВСК: " Ulyanovsk "
  УЛЬЯНОВСК-КАРШИ: " Ulyanovsk-KARSHI "
  УЛЬЯНОВСКИЙ: " Ulyanovsk "
  УМАНЬ: " Uman "
  УМЕТ: " Umet "
  УНГЕНЫ: " Ungeny "
  УНЕЧА: " Unecha "
  УПОРОВО: " UPOROVO "
  УРА-ТЮБЕ: " Uratube "
  УРАЙ: " Urai"
  УРАЛЬСК: "URALSK "
  УРГЕНЧ: " URGENCH "
  УРГУТ: " Urgut "
  УРДЖАР: " Urdzhar "
  УРЕНЬ: " Uren "
  УРЖУМ: " Urzhum "
  УРИЦКИЙ: " Uritsky "
  УРМАРЫ: " URMARY "
  УРУС-МАРТАН: " Urus-Martan "
  УРЮПИНСК: " Urjupinsk "
  УСАДИЩЕ: " USADISCHE "
  УСВЯТЫ: " Usvyat "
  УСИНСК: " Usinsk "
  УСМАНЬ: " USMANOV "
  УСМАТ: " USMAT "
  УСОГОРСК: " USOGORSK "
  УСОЛЬЕ: " Usolye "
  УСОЛЬЕ-СИБИРСК: " Usolye SIBERIAN "
  УСПЕНКА: " Uspenka "
  УСПЕНСКОЕ: " USPENSKOE "
  УССУРИЙСК: " Ussuriysk "
  УСТИНОВКА: " Ustinivka "
  УСТЬ-БОЛЬШЕРЕЦК: " Ust - Bolsheretsk "
  УСТЬ-ДЖЕГУТА: " Ust-Dzheguta "
  УСТЬ-ДОНЕЦК: " Ust-Donetsk"
  УСТЬ-ИЛИМСК: "Ust-Ilim "
  УСТЬ-ИШИМ: " Ust-Ishim "
  УСТЬ-КАЛМАНКА: " Ust-Kalmanka "
  УСТЬ-КАМЕНОГОР: " Ust-KAMENOGOR "
  УСТЬ-КАМЧАТСК: " Ust-Kamchatskij "
  УСТЬ-КАТАВ: " UST-Kata "
  УСТЬ-КИШЕРТЬ: " Ust-Kishert "
  УСТЬ-КУБИНСКОЕ: " Ust-Cuba "
  УСТЬ-КУЛОМ: " Ust-Kul "
  УСТЬ-КУТ: " Ust-Kut "
  УСТЬ-ЛАБИНСК: " Ust-labinsk "
  УСТЬ-ОМЧУГ: " Ust-Omchug "
  УСТЬ-ОРДЫНСКИЙ: " Ust - Ordynskij "
  УСТЬ-ТАРКА: " Ust-TARKA "
  УСТЬ-УДА: " UST-UDA "
  УСТЬ-ЦИЛЬМА: " Ust-Tzilma "
  УСТЬ-ЧАРЫШСКАЯ: " Ust-Charish "
  УСТЬЕ: " MOUTH "
  УСТЮЖНА: " USTYUZHNA "
  УТЕНА: " Utena "
  УХОЛОВО: " UHOLOVO "
  УХТА: " Ukhta "
  УЧАРАЛ: " Ucharal "
  УЧКИЗЫЛ: " UCHKIZYL "
  УЧКУПРИК: " Uchkuprik"
  УЧКУРГАН: "Uchqo&#39;rg&#39;on "
  УШАКИ: " USHAKOV "
  УШАЧИ: " Vušačy "
  УШТОБЕ: " Ushtobe "
  ФАЙЗАБАД: " Faizabad "
  ФАЛЕНКИ: " Falenki "
  ФАЛЕШТЫ: " Falesti "
  ФАРАБ: " FARABI "
  ФАРХОД: " Farhad "
  ФАСТОВ: " FAST "
  ФАТЕЖ: " Fatezh "
  ФЕДОРОВКА: " Fedorovka "
  ФЕДОРОВСКОЕ: " Fedorovskij "
  ФЕОДОСИЯ: " Feodosiya "
  ФЕРГАНА: " TASHKENT "
  ФЕРЗИКОВО: " FERZIKOVO "
  ФЕРШАМПЕНАУЗ: " FERSHAMPENAUZ "
  ФИРОВО: " Firova "
  ФЛОРЕШТЫ: " Floresti "
  ФОРНОСОВО: " FORNOSOVO "
  ФРОЛОВО: " FROLOVA "
  ФРУНЗЕ: " FRUNZE "
  ФРУНЗЕНСКОЕ: " FRUNZENSKY "
  ФРУНЗОВКА: " Frunzivka "
  ФУРМАНОВ: " FURMANOV"
  ФУРМАНОВКА: "Furmanovka "
  ФУРМАНОВО: " Furmanova "
  ХААПСАЛУ: " HAAPSALU "
  ХАБАРОВСК: " Khabarovsk "
  ХАБАРЫ: " Khabar "
  ХАВАЛИНГ: " HAVALING "
  ХАЗАРАСП: " Khazarasp "
  ХАККУЛАБАД: " Khakkulabad "
  ХАЛАЧ: " Halachó "
  ХАНДЫГА: " Khandyga "
  ХАНКА: " HANCO "
  ХАНТЫ-МАНСИЙСК: " Moscow "
  ХАРАБАЛИ: " Harabali "
  ХАРОВСК: " Kharovsk "
  ХАРЦЫЗСК: " Khartsizk "
  ХАРЬКОВ: " Kharkov "
  ХАРЬЮС: " HARYUS "
  ХАТАСЫ: " HATASY "
  ХАХАРАСП: " HAHARASP "
  ХАЧМАС: " Khachmas "
  ХАШУРИ: " Khashuri "
  ХВАЛЫНСК: " Khvalynsk "
  ХВАСТОВИЧИ: " HVASTOVICHI "
  ХВОЙНАЯ: " CONIFEROUS "
  ХЕРСОН: " HERSON"
  ХИВА: "HANOVER "
  ХИЛОК: " Hilok "
  ХИСЛАВИЧИ: " Khislavichi "
  ХЛЕВНОЕ: " solid farm "
  ХМЕЛЬНИК: " Khmelnik "
  ХМЕЛЬНИЦКИЙ: " Uzhgorod "
  ХОДЖААБАД: " Khodjaabad "
  ХОДЖАМБАС: " HODZHAMBAS "
  ХОДЖЕЙЛИ: " Khodjeyli "
  ХОЙНИКИ: " Chojnik "
  ХОЛМ-ЖИРКОВСКИЙ: " HILL-ZHIRKOVSKY "
  ХОЛМСК: " Kholmsk "
  ХОМУТОВКА: " Khomutovka "
  ХОМУТОВО: " Khomutova "
  ХОРИНСК: " Horinsk "
  ХОРОЛ: " Horol "
  ХОРОЛЬ: " Horol "
  ХОТИМСК: " Khotimsk "
  ХОТИН: " Hawtin "
  ХОТЫНЕЦ: " HOTYNETS "
  ХОХОЛЬСКИЙ: " HOHOLSKY "
  ХРАБРАВО: " HRABRAVO "
  ХРИСТИНОВКА: " Hristinovka "
  ХРОМТАУ: " Khromtau "
  ХУНЗАХ: " Hunza"
  ХУСТ: "Hust "
  ЦАЛКА: " Tsalka "
  ЦАРИЧАНКА: " Tsarichanka "
  ЦАХКАОВИТ: " Tsakhahovit "
  ЦВЕЛОДУБОВО: " TSVELODUBOVO "
  ЦЕЛИНА: " Celina "
  ЦЕЛИННОЕ: " Celina "
  ЦЕЛИННОС: " TSELINNOS "
  ЦЕЛИНОГРАД: " Tselinograd "
  ЦЕЛИНСКОЕ: " Szelinski "
  ЦЕСИС: " CĒSIS "
  ЦИВИЛЬСК: " Tsivilsk "
  ЦУМАНЬ: " Tsoumani "
  ЦХАЛТУБА: " TSKHALTUBO "
  ЦХИНВАЛИ: " TSKHINVALI "
  ЦЮРУПИНСК: " Tsyurupinsk "
  ЧАГОДА: " Chagoda "
  ЧАДЫР-ЛУНГА: " CIADIR LUNGA "
  ЧАЕК: " gulls "
  ЧАЙКОВСКИЙ: " Tchaikovsky "
  ЧАЛТЫРЬ: " Chaltyr "
  ЧАМЗИНКА: " Chamzinka "
  ЧАНЫ: " CHANY "
  ЧАПАЕВ: " CHAPAEV "
  ЧАПАЕВСК: " Chapaevsk"
  ЧАПЛЫГИН: "Chaplygin "
  ЧАПЛЫНКА: " Chaplynka "
  ЧАРА: " Chara "
  ЧАРДЖОУ: " Chardjou "
  ЧАРЕНЦАВАН: " Charentsavan "
  ЧАРСК: " Chara "
  ЧАРТАП: " CHARTAP "
  ЧАРШАНГА: " CHARSHANGA "
  ЧАРЫШСКОЕ: " Charish "
  ЧАСОВОНСКОЕ: " CHASOVONSKOE "
  ЧАСТООЗЕРЬЕ: " CHASTOOZERE "
  ЧАСТЫЕ: " FAQ "
  ЧАТКАЛ: " CHATKAL "
  ЧАУСЫ: " CEAUSU "
  ЧАШНИКИ: " Chashniky "
  ЧЕБАКУЛЬ: " CHEBAKUL "
  ЧЕБОКСАРЫ: " Cheboksary "
  ЧЕГДОМЫН: " Chegdomyn "
  ЧЕГЕМ: " Chegem "
  ЧЕКМАГУШ: " CHEKMAGUSH "
  ЧЕЛКАР: " Chelkar "
  ЧЕЛНО-ВЕРШИНЫ: " Chelny-PEAK "
  ЧЕЛЯБИНСК: " Chelyabinsk "
  ЧЕМЕРОВЦЫ: " Chemerivtsi "
  ЧЕРВЕНЬ: " Cserveny"
  ЧЕРВОНОАРМЕЙСК: "Chervonoarmejsk "
  ЧЕРВОНОГРАД: " Chervonograd "
  ЧЕРДАКЛЫ: " Cherdakly "
  ЧЕРЕМИСИНОВО: " Cheremisinova "
  ЧЕРЕМХОВО: " Cherm "
  ЧЕРЕМШАН: " Cheremshany "
  ЧЕРЕПАНОВО: " Cherepanov "
  ЧЕРЕПОВЕЦ: " CHEREPOVETS "
  ЧЕРИКОВ: " Cherikov "
  ЧЕРКАСОВО: " CHERKASOVA "
  ЧЕРКАССЫ: " Cherkassy "
  ЧЕРКЕССК: " Cherkessk "
  ЧЕРЛАК: " Cherlak "
  ЧЕРНИГОВ: " Chernihiv "
  ЧЕРНИГОВКА: " Chernigovka "
  ЧЕРНОБАЙ: " Chernobaev "
  ЧЕРНОБЫЛЬ: " Chernobyl "
  ЧЕРНОВЦЫ: " Chernivtsi "
  ЧЕРНОГОРСК: " PODGORICA "
  ЧЕРНОМОРСКОЕ: " BLACK "
  ЧЕРНУХИ: " Chernuhi "
  ЧЕРНУШКА: " Nigella "
  ? "ЧЕРНЫЙ ЯР"
  : " Black DM "
  ЧЕРНЫШЕВСК: " Chernyshevsk "
  ЧЕРНЫШКОВСКИЙ: " CHERNYSHKOVSKY"
  ЧЕРНЬ: "Black "
  ЧЕРНЯНКА: " Chernyanka "
  ЧЕРНЯХОВ: " Chernyakhiv "
  ЧЕРНЯХОВСК: " Chernyahovsk "
  ЧЕРТКОВО: " Chertkov "
  ЧЕСМА: " Cesme "
  ЧЕХОВ: " CHEKHOV "
  ЧЕЧЕЛЬНИК: " Chechelnik "
  ЧЕЧЕРСК: " Chechersk "
  ЧИГИРИН: " Chigirin "
  ЧИКОЛА: " Chikola "
  ЧИЛИК: " Chilik "
  ЧИМБАЙ: " Chimbai "
  ЧИМИШЛИЯ: " CIMISLIA "
  ЧИМКЕНТ: " Shymkent "
  ЧИНАЗ: " Chinaz "
  ЧИРАКЧИ: " Chirakchi "
  ЧИРЧИК: " CHIRCHIK "
  ЧИСТООЗЕРНОЕ: " CHISTOOZERNOE "
  ЧИСТОПОЛЬ: " Tchistopol "
  ЧИСТОПОЛЬЕ: " Tchistopol "
  ЧИТА: " Read more "
  ЧИШМЫ: " Chishmy "
  ЧКАЛОВО: " CHKALOV "
  ЧКАЛОВСК: " CHKALOVSK"
  ЧОЛПАН-АТА: "Cholpan-ATA "
  ЧОРТКОВ: " Chortkiv "
  ЧУГУЕВ: " Chuguyiv "
  ЧУГУЕВКА: " Chuguevka "
  ЧУДНОВ: " Chudnov "
  ЧУДОВО: " Chudovo "
  ? "ЧУДСКОЙ БОР"
  : " PEIPSI BOR "
  ЧУЛЫМ: " CHULYM "
  ЧУНДЖА: " Chungju "
  ЧУНСКИЙ: " Chunsky "
  ЧУРАПЧА: " CHURAPCHA "
  ЧУСОВОЙ: " Chusovaya "
  ЧУСТ: " Chust "
  ЧУТОВО: " Chutovo "
  ЧУХЛОМА: " Chukhloma "
  ЧУЧКОВО: " CHUCHKOVO "
  ШАБЛЫКИНО: " Shablykino "
  ШАВАТ: " Shavat "
  ШАДРИНСК: " Shadrinsk "
  ШАКЯЙ: " Shakiai "
  ШАЛИ: " Shawls "
  ШАЛИНСКОЕ: " Shali "
  ШАЛЬЧИНИНКАЙ: " Shalchininkai "
  ШАПКИ: " HATS "
  ШАРАН: " BALL"
  ШАРГОРОД: "Shargorod "
  ШАРКАН: " shuffling "
  ШАРКОВЩИНА: " Sharkovschina "
  ШАРЛЫК: " Sharlyk "
  ШАРЫПОВО: " Sharypova "
  ШАРЬЯ: " Sharia "
  ШАТРОВО: " Shatrova "
  ШАТУРА: " Shatura "
  ШАФИРКАН: " Shafirkan "
  ШАХОВСКАЯ: " Shakhovskoi "
  ШАХРИХАН: " Shakhrikhan "
  ШАХРНСАБЗ: " SHAHRNSABZ "
  ШАХТЕРСК: " VOROSHYLIVSKE "
  ШАХТИНСК: " Shakhtinsk "
  ШАХТЫ: " MINE "
  ШВЕНЧЕНИС: " Svencionys "
  ШЕБАЛИНО: " Shebalin "
  ШЕВЧЕНКО: " Shevchenko "
  ШЕВЧЕНКОВО: " Shevchenkovo "
  ШЕКИ: " Sheki "
  ШЕКСНА: " SHEKSNA "
  ШЕЛАБОЛИХА: " SHELABOLIHA "
  ШЕЛЕХОВ: " Shelekhov "
  ШЕЛКОВСКАЯ: " Shelkovskiy "
  ШЕЛОПУГИНО: " SHELOPUGINO"
  ШЕМАХА: "Shemaxa "
  ШЕМОНАИХА: " Shemonaikha "
  ШЕМУРША: " Shemursha "
  ШЕМЫШЕЙКА: " SHEMYSHEYKA "
  ШЕНТАЛА: " SHENTALA "
  ШЕПЕТОВКА: " Shepetovka "
  ШЕРАБАТ: " SHERABAT "
  ШИГОНЫ: " Shigony "
  ШИЛАЛЕ: " Silale "
  ШИЛКА: " Shilka "
  ШИЛОВО: " SHILOV "
  ШИЛУТЕ: " Silute "
  ШИМАНОВСК: " SHIMANOVSKY "
  ШИМСК: " Shimskaya "
  ШИПУНОВО: " Shipunovo "
  ШИРВИНТОС: " Sirvintos "
  ШИРИН: " Width "
  ШИРОКОЕ: " BROAD "
  ШИРЯЕВО: " Shiryaevo "
  ШИШАКИ: " Shishaki "
  ШКЛОВ: " Shklov "
  ШОЛДАНЕШТЫ: " Soldanesti "
  ШОРТАНДЫ: " Shortandy "
  ШОСТКА: " Shostka "
  ШПАКОВСКОЕ: " SHPAKOVSKY"
  ШПОЛА: "Shpola "
  ШУЙСКОЕ: " SHUISKI "
  ШУЛИХА: " SHULIHA "
  ШУМЕРЛЯ: " Shumerlya "
  ШУМИЛИНО: " Shumilino "
  ШУМИХА: " buzz "
  ШУМСКОЕ: " Shumsk "
  ШУМЯЧИ: " SHUMYACHI "
  ШУРЧИ: " Shurchi "
  ШУША: " SHUSHA "
  ШУШЕНСКОЕ: " Shushensky "
  ШЯУЛЯЙ: " ŠIAULIAI "
  ЩЕБЕКИНО: " SCHEBEKINO "
  ЩЕГЛОВ: " SCHEGLOV "
  ЩЕКИНО: " Shchekin "
  ЩЕЛКОВО: " Schyolkovo "
  ЩЕРБАКТЫ: " SCHERBAKTY "
  ЩЕРБАКУЛЬ: " SCHERBAKUL "
  ЩИГРЫ: " Shchigry "
  ЩОРС: " Schors "
  ЩУЧИН: " Ščučyn "
  ЩУЧИНСК: " Shchuchinsk "
  ЫТЫК-КЮЕЛЬ: " Ytyk-Kyuyol "
  ЭКИБАСТУЗ: " Ekibastuz "
  ЭЛЕКТРЕНАЙ: " Elektrenai"
  ЭЛЕКТРОСТАЛЬ: "ELEKTROSTAL "
  ЭЛИСТА: " Elista "
  ЭЛЬХОТОВО: " ELHOTOVO "
  ЭНГЕЛЬС: " Engels "
  ЭНЕРГЕТИЧЕСКИЙ: " Energy "
  ЭНЕРГОДАР: " Energodar "
  ЭРТИЛЬ: " Ertil "
  ЭССО: " ESSO "
  ЭЧМИАДЗИН: " ECHMIADZIN "
  ЮЖНО-САХАЛИНСК: " Yuzhno-Sakhalinsk "
  ЮЖНОУКРАИНСК: " Yuzhnoukrayinsk "
  ЮЖНОУРАЛЬСК: " YUZHNOURALSKY "
  ЮКАМЕНСКОЕ: " Yukamenskaya "
  ЮНОКОММУНАРСК: " YUNOKOMMUNARSK "
  ЮРБАРКАС: " Jurbarkas "
  ЮРГА: " Jurga "
  ЮРГАМЫШ: " YURGAMYSH "
  ЮРИНО: " Jurin "
  ? "ЮРЬЕВ ПОЛЬСКИЙ"
  : " YURYEV Polish "
  ЮРЬЕВЕЦ: " Yurievets "
  ЮРЬЯ: " Jurjans "
  ЮХНОВ: " Yukhnov "
  ЯВЛЕНКА: " YAVLENKA "
  ЯВОРОВ: " Yavoriv "
  ЯГОДНОЕ: " BERRY"
  ЯГОТИН: "Yagotin "
  ЯДРИН: " Yadrin "
  ЯЗЫКОВО: " Language "
  ЯЗЬЯВАН: " YAZYAVAN "
  ЯЙПАН: " YAYPAN "
  ЯККАБАГ: " Yakkabag "
  ЯКОВЛЕВКА: " YAKOVLEVKA "
  ЯКУТСК: " YAKUTSK "
  ? "ЯКШУР БОДЬЯ"
  : " Yakshur Bodian "
  ЯКШУР-БОДЬЯ: " Yakshur-Bodian "
  ЯЛТА: " Yalta "
  ЯЛУТОРОВСК: " Yalutorovsk "
  ЯМПАЛЬ: " YAMPAL "
  ЯМПОЛЬ: " Yampil "
  ЯНАВАН: " YANAVAN "
  ЯНАУЛ: " Yanaul "
  ЯНГИ-МИРИШКОР: " Yangi-Mirishkor "
  ЯНГИ-НИШАН: " Yangi-Nishan "
  ЯНГИАБАД: " Yangiabad "
  ЯНГИАРЫК: " YANGIARYK "
  ЯНГИАУЛ: " YANGIAUL "
  ЯНГИБАЗАР-БУХАР: " Yangibazar Bukhari "
  ЯНГИБАЗАР-ТАШК.: " Yangibazar-Tashko. "
  ЯНГИБАЗАР-УРГЕН: " Yangibazar-URGEN "
  ЯНГИЕР: " Yangiyer"
  ЯНГИКУРГАН: "YANGIKURGAN "
  ? "ЯНГИКУРГАН НАМ"
  : "YANGIKURGAN U.S. "
  ЯНГИЮЛЬ-ТАШКЕНТ: " Yangiyul-TASHKENT "
  ЯНГИЮЛЬ-ТЕРМЕЗ: " Yangiyul-TERMEZ "
  ЯНИНО: " Ioannina "
  ЯНТАРНОЕ: " AMBER "
  ЯНТИКОВО: " YANTIKOVO "
  ЯНШИКИШЛАК: " YANSHIKISHLAK "
  ЯРАНСК: " Yaransk "
  ЯРЕМЧА: " YAREMCHE "
  ЯРКОВО: " Yarkov "
  ЯРМОЛИЦЫ: " YARMOLITSY "
  ЯРОСЛАВЛЬ: " Yaroslavl "
  ЯРЦЕВО: " Yartseva "
  ЯСИНОВАТАЯ: " Yasinuvata "
  ЯСИНОГОРСК: " YASINOGORSK "
  ЯСНОГОРСК: " Yasnogorsk "
  ЯШИНО: " Yashin "
  ЯШКИНО: " Yashkin "
? !ruby/symbol uk
: 
  АБАЙ: " Абай "
  АБАКАН: " АБАКАН "
  АБАН: " Абані "
  АБДУЛИНО: " АБДУЛІНА "
  АБИНСК: " Абінськ "
  АБОВЯН: " Абовян "
  АВДЕЕВКА: " АВДІЇВКА "
  АГАПОВКА: " АГАПОВКА "
  АГДАМ: " Агдам "
  АГИНСКОЕ: " Агінський "
  АГРЫЗ: " агриз "
  АДАМОВКА: " Адамівка "
  АДЛЕР: " АДЛЕР "
  АЗИЗБЕКОВ: " Азізбек "
  АЗНАКАЕВО: " Азнакаево "
  АЗОВ: " АЗОВ "
  АЙКИНО: " АЙКІНО "
  АКАЛТЫН: " АКАЛТИН "
  АКЖАР: " АКЖАР "
  АКИМОВКА: " АКИМІВКА "
  АККОЛЬ: " Акколь "
  АККУРГАН: " АККУРГАН "
  АКМАНГИТ: " АКМАНГІТ "
  АКСАЙ: " АКСА"
  АКСУБАЕВО: "АКСУБАЕВО "
  АКТАНЫШ: " АКТАНИШ "
  АКТАШ: " Акташ "
  АКТЮБИНСК: " Актюбінськ "
  АКША: " Акшай "
  АЛАБУКА: " АЛАБУКА "
  АЛАВЕРДЫ: " Алаверди "
  АЛАГИР: " Алагир "
  АЛАПАЕВСК: " Алапаєвськ "
  АЛАТ: " АЛАТ "
  АЛАТЫРЬ: " алатир "
  АЛГА: " АЛГА "
  АЛДАН: " Алдан "
  АЛЕЙСК: " Алейськ "
  АЛЕКСАНДР-НЕВСК: " Олександро-Невському "
  АЛЕКСАНДРИЯ: " ОЛЕКСАНДРІЯ "
  АЛЕКСАНДРОВ: " АЛЕКСАНДРОВ "
  ? "АЛЕКСАНДРОВ ГАЙ"
  : " АЛЕКСАНДРОВ ГАЙ "
  АЛЕКСАНДРОВКА: " Олександрівка "
  АЛЕКСАНДРОВСК: " ОЛЕКСАНДРІВСЬК "
  АЛЕКСАНДРОВСКОЕ: " АЛЕКСАНДРОВСЬКА "
  АЛЕКСЕВКА: " АЛЕКСЕВКА "
  АЛЕКСЕЕВКА: " ОЛЕКСІЇВКА "
  АЛЕКСЕЕВСКОЕ: " Олексіївської "
  АЛЕКСИН: " Алексин"
  АЛИ-БАЙРАМЛЫ: "Алі-Байрамли "
  АЛИКОВО: " АЛІКОВО "
  АЛИТУС: " Алітус "
  АЛМА-АТА: " АЛМА-АТА "
  АЛМАЛЫК: " Алмалик "
  АЛНАШИ: " АЛНАШІ "
  АЛТАЙСКИЙ: " Алтайський "
  АЛТЫАРЫК: " АЛТИАРИК "
  АЛТЫНКУЛЬ: " АЛТИНКУЛЬ "
  АЛУКСНЕ: " Алуксне "
  АЛУШТА: " АЛУШТА "
  АЛЬМЕНЕВО: " АЛЬМЕНЕВО "
  АЛЬМЕТЬЕВСК: " Альметьєвська "
  АМВРОСИЕВКА: " Амвросіївка "
  АМГА: " Амга "
  АМУРСК: " АМУРСЬКА "
  АНАНЬЕВ: " Ананьїв "
  АНАПА: " АНАПА "
  АНГАРСК: " Ангарськ "
  АНГОР: " АНГОР "
  АНГРЕН: " Ангра "
  АНДИЖАН: " Андижан "
  АНДРЕАПОЛЬ: " АНДРЕАПОЛЬ "
  АНДРИАНОВО: " Андріанова "
  АНДРОНОВСКОЕ: " Андронівська"
  АНДРУШЕВКА: "Андрушівка "
  АНЖЕРО-СУДЖЕНСК: " Анжеро-Судженськ "
  АНИВА: " Аніва "
  АНИКЩЯЙ: " АНІКЩЯЙ "
  АНИНО: " Аніна "
  АННА: " АННА "
  АННАУ: " Анна "
  АНРЕЕВКА: " АНРЕЕВКА "
  АНТРАЦИТ: " АНТРАЦИТ "
  АНТРОПОВО: " Антропова "
  АНУЧИНО: " Анучина "
  АПАРАН: " апарать "
  АПАСТОВО: " АПАСТОВО "
  АПАТИТЫ: " Апатити "
  АПОСТОЛОВО: " АПОСТОЛОВЕ "
  АПШЕРОНСК: " Апшеронськ "
  АРАВАН: " Араван "
  АРБУЗИНКА: " АРБУЗИНКА "
  АРГАЯШ: " АРГАЯШ "
  АРГУН: " АРГУНЬ "
  АРДАТОВ: " Ардатов "
  АРДОН: " Ардон "
  АРЗАМАС: " Арзамас "
  АРКАДАК: " Аркадак "
  АРКАЛЫК: " Аркалик"
  АРМАВИР: "АРМАВІР "
  АРСЕНЬЕВ: " АРСЕНЕ "
  АРСЕНЬЕВО: " Арсеньєва "
  АРСК: " Арськ "
  АРТАШАТ: " Арташаті "
  АРТЕМ: " АРТЕМ "
  АРТЕМОВСК: " АРТЕМІВСЬК "
  АРТЕМОВСКИЙ: " АРТЕМІВСЬКИЙ "
  АРТИ: " Арті "
  АРТИК: " Артик "
  АРХАНГЕЛЬСК: " АРХАНГЕЛЬСЬК "
  АРХАНГЕЛЬСКОЕ: " АРХАНГЕЛЬСЬК "
  АРХОНКА: " АРХОНКА "
  АРЦИЗ: " Арциз "
  АРЫКБАЛЫК: " АРИКБАЛИК "
  АСБЕСТ: " азбесту "
  АСИНО: " Асина "
  АСКАРОВО: " Аскарово "
  АСКИНО: " АСКІНО "
  АССА: " АССА "
  АСТАРА: " АСТАР "
  АСТРАХАНКА: " АСТРАХАНКА "
  АСТРАХАНЬ: " АСТРАХАНЬ "
  АТБАСАР: " атбасар "
  АТБАШИ: " Атбаш"
  АТКАРСК: "АТКАРСЬК "
  АТЮРЬЕВО: " АТЮРЬЕВО "
  АТЯШЕВО: " атяшево "
  АХАЛКАЛАКИ: " Ахалкалакі "
  АХАНГАРАН: " АХАНГАРАН "
  АХМЕТА: " Ахмет "
  АХСУ: " йому Ахсу "
  АХТУБИНСК: " Ахтубінськ "
  АХТЫРКА: " АХТИРКА "
  АХУНБАБАЕВ: " АХУНБАБАЕВ "
  АЧИНСК: " Ачинськ "
  АЧХОЙ-МАРТАН: " Ачхой-Мартан "
  АШТАРАК: " Аштарак "
  АШХАБАД: " Ашхабад "
  АЯГУЗ: " АЯГУЗ "
  Б-БЕРЕЗНИКИ: " Б-Березники "
  Б-ВЛАДИМИРОВКА: " Б-Володимирівка "
  Б-ГЛУШИЦА: " Б-Глушиця "
  Б-ИГНАТОВО: " Б-ІГНАТОВА "
  Б-ИЖОРА: " Б - Іжори "
  Б-КОЛПАНЫ: " Б-КОЛПАНИ "
  Б-МАРТЫНОВКА: " Б-Мартинівка "
  Б-НАГАТКИНО: " Б-Нагаткіна "
  Б-СОЛДАТСКОЕ: " Б-солдатських "
  Б-СОРОКИНО: " Б-СОРОКІНА"
  Б-СОСНОВКА: "Б-Соснівка "
  Б-ЧЕРНИГОВКА: " Б-Чернігівка "
  БАБАЕВО: " БАБАЄВА "
  БАБУШКИНО: " БАБУШКІНА "
  БАБЫЛИНО: " БАБИЛІНО "
  БАВЛЫ: " бавлю "
  БАГАЕВСКОЕ: " Багаєвська "
  БАГАН: " БАГАН "
  БАГАТ: " багато "
  БАГДАД: " БАГДАД "
  БАГРАТИОНОВСК: " БАГРАТІОНОВСК "
  БАЕВО: " Баєв "
  БАЗ-КАРБУЛАК: " БАЗ-КАРБУЛАК "
  БАЗАР-КОРГОН: " БАЗАР-КОРГОН "
  ? "БАЗАРНЫЕ МАТАКИ"
  : " БАЗАРНИЙ МАТАКІ "
  БАЙКАДАМ: " БАЙКАДАМ "
  БАЙРАМ-АЛИ: " БАЙРАМ-АЛИ "
  БАЙСУН: " БАЙСУН "
  БАКАЛЫ: " Бакали "
  БАКАНАС: " БАКАНАС "
  БАКСАН: " Баксан "
  БАКУ: " БАКУ "
  БАЛАБАНОВО: " Балабанова "
  БАЛАКЛЕЯ: " БАЛАКЛІЯ "
  БАЛАКОВО: " Балаково"
  БАЛАХНА: "Балахна "
  БАЛАХТА: " БАЛАХТА "
  БАЛАШОВ: " БАЛАШОВ "
  БАЛВИ: " Балві "
  БАЛЕВИНО: " БАЛЕВІНО "
  БАЛЕЗИНО: " БАЛЕЗІНО "
  БАЛЕЙ: " Балей "
  БАЛКАШИНО: " Балкашинов "
  БАЛТА: " БАЛТА "
  БАЛТАЙ: " БАЛТАЙ "
  БАЛТАСИ: " БАЛТАСІ "
  БАЛТИЙСК: " БАЛТІЙСЬКЕ "
  БАЛХАШ: " Балхаш "
  БАЛЫКЧИ: " БАЛИКЧІ "
  БАРАБИНСК: " барабинськ "
  БАРАНОВИЧИ: " БАРАНОВИЧІ "
  БАРАНОВКА: " БАРАНІВКА "
  БАРВЕНКОВО: " Барвінкове "
  БАРГУЗИН: " Баргузин "
  БАРДА: " БАРД "
  БАРНАУЛ: " БАРНАУЛ "
  БАРШАТАС: " БАРШАТАС "
  БАРЫШ: " Бариш "
  БАРЫШЕВКА: " БАРИШІВКА "
  БАРЯТИНО: " барятин"
  БАТАЙСК: "Батайськ "
  БАТАМШИНСКИЙ: " БАТАМШІНСКІЙ "
  БАТЕЦКИЙ: " БАТЕЦЬКА "
  БАТОВО: " Батов "
  БАТУМИ: " БАТУМІ "
  БАТЫРЕВО: " БАТИРЕВО "
  БАУСКА: " Бауска "
  БАХАРДЕН: " Бахардену "
  БАХМАЧ: " БАХМАЧ "
  БАХЧИСАРАЙ: " БАХЧИСАРАЙ "
  БАШМАКОВО: " Башмакова "
  БАШТАНКА: " БАШТАНКА "
  БЕДНОДЕМЯНСК: " БЕДНОДЕМЯНСК "
  БЕЖАНИЦЫ: " БЕЖАНІЦИ "
  БЕЖЕЦК: " Бєжецький "
  БЕЗЕНЧУК: " безенчук "
  БЕЗМЕИН: " БЕЗМЕІН "
  БЕЙЛАГАН: " БЕЙЛАГАН "
  БЕКАБАД: " БЕКАБАД "
  БЕЛАЯ: " БІЛА "
  ? "БЕЛАЯ ГЛИНА"
  : " біла глина "
  ? "БЕЛАЯ КАЛИТВА"
  : " біла калитва "
  ? "БЕЛАЯ ХОЛУНИЦА"
  : " БІЛА ХОЛУНІЦА "
  ? "БЕЛАЯ ЦЕРКОВЬ"
  : " БІЛА ЦЕРКВА "
  БЕЛГОРОД: " БІЛГОРОД"
  БЕЛЕБЕЙ: "Белебей "
  БЕЛЕВ: " Белев "
  БЕЛИНСКИЙ: " БЕЛІНСЬКИЙ "
  БЕЛОВО: " БЄЛОВ "
  БЕЛОВОДСК: " БІЛОВОДСЬКИЙ "
  БЕЛОГОРСК: " БІЛОГІРСЬКЕ "
  БЕЛОГОРЬЕ: " Білогір&#39;я "
  БЕЛОЗЕРКА: " Білозерка "
  БЕЛОЗЕРСК: " БІЛОЗЕРСЬКИЙ "
  БЕЛОЗЕРСКОЕ: " БІЛОЗЕРСЬКИЙ "
  БЕЛОКУРАКИНО: " Білокуракине "
  БЕЛОКУРИХА: " Белокуріха "
  БЕЛОМОРСК: " Бєломорськ "
  БЕЛОПОЛЬЕ: " Білопілля "
  БЕЛОРЕЦК: " Бєлорєцьк "
  БЕЛОРЕЧЕНСК: " Бєлорєченськ "
  БЕЛОЯРСКИЙ: " Білоярської "
  ? "БЕЛЫЕ ВОДЫ"
  : " БІЛІ ВОДИ "
  БЕЛЫЙ: " БІЛИЙ "
  ? "БЕЛЫЙ ЯР"
  : " БІЛИЙ ЯР "
  БЕЛЫНИЧИ: " Бєлиничі "
  БЕЛЬЦЫ: " БЄЛЬЦІ "
  БЕЛЯЕВКА: " БІЛЯЇВКА "
  БЕНДЕРЫ: " БЕНДЕРИ "
  БЕРД: " Берд"
  БЕРДИГЕСТЯХ: "Бердигестях "
  БЕРДИЧЕВ: " БЕРДИЧІВ "
  БЕРДСК: " Бердськ "
  БЕРДЮЖЬЕ: " БЕРДЮЖЬЕ "
  БЕРДЯНСК: " БЕРДЯНСЬК "
  БЕРЕГОВО: " БЕРЕГОВО "
  БЕРЕЖАНЫЙ: " БЕРЕЖАНИ "
  БЕРЕЖКИ: " Бережки "
  БЕРЕЗА: " БЕРЕЗА "
  БЕРЕЗАНКА: " БЕРЕЗАНКА "
  БЕРЕЗИНО: " БЕРЕЗІНЕ "
  БЕРЕЗНИГОВАТОЕ: " БЕРЕЗНІГОВАТОЕ "
  БЕРЕЗНИК: " Березники "
  БЕРЕЗНИКИ: " Березники "
  БЕРЕЗНО: " БЕРЕЗНЯ "
  БЕРЕЗОВКА: " БЕРЕЗІВКА "
  БЕРЕЗОВО: " БЕРЕЗОВИЙ "
  БЕРЕЗОВСКИЙ: " БЕРЕЗОВСЬКИЙ "
  БЕРЕСТОВИЦА: " БЕРЕСТОВІЦА "
  БЕРИСЛАВ: " БЕРИСЛАВ "
  БЕРУНИ: " Берун "
  БЕРШАДЬ: " БЕРШАДЬ "
  БЕСЛАН: " БЕСЛАН "
  БЕССАРАБКА: " Бессарабка "
  БЕССОНОВКА: " БЕССОНОВКА"
  БЕШЕНКОВИЧИ: "Бешенковичі "
  БЕШКЕНТ: " БЕШКЕНТ "
  БЕШРАБАТ: " БЕШРАБАТ "
  БИЖБУЛЯК: " БІЖБУЛЯК "
  БИЙСК: " Бійськ "
  БИЛИБИНО: " Білібін "
  БИРЖАЙ: " Біржай "
  БИРОБИДЖАН: " Біробіджан "
  БИРСК: " Бірськ "
  БИРШТОНАС: " Бірштонас "
  БИЧУРА: " Бічура "
  БЛАГОВЕЩЕНКА: " Благовіщенка "
  БЛАГОВЕЩЕНСК: " БЛАГОВІЩЕНСЬКИЙ "
  БЛАГОДАРНЫЙ: " подяки "
  БЛИЗНЮКИ: " БЛИЗНЮКИ "
  БОБРИНЕЦ: " БОБРИНЕЦЬ "
  БОБРОВ: " БОБРОВ "
  БОБРОВИЦА: " БОБРОВИЦЯ "
  БОБРУЙСК: " БОБРУЙСЬК "
  ? "БОГАТЫЕ САБЫ"
  : " БАГАТІ Саби "
  БОГДАНОВИЧ: " БОГДАНОВИЧ "
  БОГДАНОВКА: " Богданівка "
  БОГОДУХОВ: " БОГОДУХІВ "
  БОГОРОДИЦК: " Богородицька "
  БОГОРОДСК: " Богородськ"
  БОГОРОДСКОЕ: "Богородський "
  БОГОРОДЧАНЫ: " Богородчани "
  БОГУСЛАВ: " БОГУСЛАВ "
  БОГУЧАР: " Богучар "
  БОЛГРАД: " БОЛГРАД "
  БОЛНИСИ: " БОЛНІСІ "
  БОЛОГОЕ: " Болог "
  БОЛОТНОЕ: " БЮЛЕТЕНІ "
  БОЛХОВ: " БОЛЕХОВ "
  ? "БОЛЬШАЯ МУРТА"
  : " ВЕЛИКА Мурті "
  БОЛЬШЕНАРЫМСКОЕ: " БОЛЬШЕНАРИМСКОЕ "
  БОЛЬШЕРЕЧЬЕ: " БОЛЬШЕРЕЧЬЕ "
  ? "БОЛЬШИЕ УКИ"
  : " ВЕЛИКІ УКІ "
  ? "БОЛЬШОЙ КАМЕНЬ"
  : " ВЕЛИКИЙ КАМІНЬ "
  ? "БОЛЬШОЙ УЛУЙ"
  : " ВЕЛИКИЙ УЛУЙ "
  БОНДАРИ: " БОНДАР "
  БОРЗНА: " БОРЗНА "
  БОРИСЛАВ: " БОРИСЛАВ "
  БОРИСОВ: " БОРИСОВ "
  ? "БОРИСОВА ГРИВА"
  : " БОРИСОВА гривень "
  БОРИСОВКА: " Борисівка "
  БОРИСОГЛЕБСК: " БОРИСОГЛІБСЬКИЙ "
  БОРИСОГЛЕБСКИЙ: " БОРИСОГЛІБСЬКИЙ "
  БОРИСПОЛЬ: " БОРИСПІЛЬ "
  БОРОВАЯ: " БОРОВА"
  БОРОВИЧИ: "Боровичі "
  БОРОВОЕ: " БОРОВА "
  БОРОВСК: " БОРОВСЬК "
  БОРОВСКОЙ: " БОРІВСЬКИЙ "
  БОРОГОНЦЫ: " БОРОГОНЦИ "
  БОРОДИНО: " БОРОДІН "
  БОРОДУЛИХА: " БОРОДУЛІХА "
  БОРОДЯНКА: " БОРОДЯНКА "
  БОРСКОЕ: " Борському "
  БОРШОВ: " Борш "
  БРАГИН: " Брагін "
  БРАСЛАВ: " Браслав "
  БРАТСК: " БРАТСЬКА "
  БРАТСКОЕ: " БРАТСЬКА "
  БРЕДЫ: " БРЕД "
  БРЕСТ: " БРЕСТ "
  БРИЧАНЫ: " БРІЧАНИ "
  БРОВАРЫ: " БРОВАРИ "
  БРОДЫ: " БРОДИ "
  БРЮХОВЕЦКАЯ: " БРЮХОВЕЦЬКА "
  БРЯНКА: " БРЯНКА "
  БРЯНСК: " БРЯНСЬК "
  БУГУЛЬМА: " Бугульма "
  БУГУРУСЛАН: " Бугуруслан "
  ? "БУДА КОШЕЛЕВО"
  : " БУДА КОШЕЛЄВОЇ"
  БУДЕННОВСК: "Будьонівськ "
  БУДОГОШЬ: " БУДОГОШЬ "
  БУЗДЯК: " БУЗДЯК "
  БУЗУЛУК: " Бузулук "
  БУИНСК: " Буїнському "
  БУКА: " БУКА "
  БУЛАЕВО: " БУЛАЕВО "
  БУРНОЕ: " Бурхливе "
  БУРШТЫН: " Бурштин "
  БУРЫНЬ: " Буринь "
  БУСК: " БУСЬКИЙ "
  БУСТАН: " Бустан "
  БУСТОН: " БУСТОН "
  БУТУРЛИНОВКА: " БУТУРЛІНОВКА "
  БУХАРА: " Бухари "
  БУЧАЧ: " БУЧАЧ "
  БЫКОВО: " БИКОВ "
  БЫСТРОВКА: " БИСТРОВКА "
  ? "БЫСТРЫЙ ИСТОК"
  : " ШВИДКИЙ ІСТОК "
  БЫХОВ: " Бихов "
  В-АЛЕКСАНДРОВКИ: " По-Олександрівка "
  В-БАГАЧКА: " По-БАГАЧКА "
  В-ЛЕПТИХА: " У -ЛЕПТІХА "
  В-МИХАЙЛОВКА: " В-Михайлівка "
  В-НОВОСЕЛКА: " В-Новосілка"
  В-РОГАЧИК: "По-РОГАЧИК "
  ВАБКЕНТ: " Вабкент "
  ВАВОЖ: " ВАВОЖ "
  ВАДИНСК: " ВАДІНСК "
  ВАДУЛ-ЛУЙ-ВОДЭ: " Вадул-луй-Воде "
  ВАЖИНЫ: " ВАЖІНИ "
  ВАЛГА: " Валга "
  ВАЛДАЙ: " ВАЛДАЙ "
  ВАЛИХАНОВО: " Валиханова "
  ВАЛКА: " ВАЛКИ "
  ВАЛКИ: " ВАЛКИ "
  ВАЛМИЕРА: " Валмієрі "
  ВАЛУЙКИ: " валуйки "
  ВАНИНО: " ВАНІНА "
  ВАННОВКА: " ВАННОВКА "
  ВАРВА: " ВАРВА "
  ВАРГАШИ: " Варгаши "
  ВАРДЕНИС: " ВАРДЕНІС "
  ВАРЕНА: " варена "
  ВАРНА: " ВАРНА "
  ВАРТЕМЯГИ: " ВАРТЕМЯГІ "
  ВАСИЛЬЕВКА: " Василівка "
  ВАСИЛЬКОВ: " ВАСИЛЬКІВ "
  ВАСИЛЬКОВКА: " Васильківка "
  ВАХРУШИ: " Вахрушев"
  ВАХШ: "Вахш "
  ВАЧА: " вача "
  ВЕДЕНО: " ведено "
  ВЕДЫ: " веди "
  ВЕЙДЕЛЕВКА: " ВЕЙДЕЛЕВКА "
  ВЕКИЛЬ-БАЗАР: " ВЕКІЛЬ-БАЗАР "
  ВЕЛ-БЕРЕЗНЫЙ: " ВЕЛ-БЕРЕЗНИЙ "
  ВЕЛ-ПИСАРЕВКА: " ВЕЛ-Писарівка "
  ВЕЛИЖ: " Веліж "
  ? "ВЕЛИКИЕ ЛУКИ"
  : " ВЕЛИКІ ЛУКИ "
  ? "ВЕЛИКИЙ БУРЛУК"
  : " ВЕЛИКИЙ БУРЛУК "
  ? "ВЕЛИКИЙ УСТЮГ"
  : " Великий Устюг "
  ВЕЛЬСК: " вельск "
  ВЕНГЕРОВО: " Венгерова "
  ВЕНЕВ: " ВЕНЕВ "
  ВЕНТСПИЛС: " Вентспілс "
  ВЕРЕЩАГИНО: " ВЕРЕЩАГІН "
  ВЕРТЕМЯГИ: " ВЕРТЕМЯГІ "
  ВЕРХ-УСУГЛИ: " ВЕРХ-УСУГЛІ "
  ВЕРХ-ЧЕБУЛА: " ВЕРХ -чебула "
  ВЕРХНЕВИЛЮЙСК: " ВЕРХНЕВІЛЮЙСК "
  ВЕРХНЕВОЛЫНСКОЕ: " ВЕРХНЕВОЛИНСКОЕ "
  ВЕРХНЕДВИНСК: " Верхньодвінськом "
  ВЕРХНЕДНЕПРОВСК: " ВЕРХНЕДНІПРОВСЬК "
  ВЕРХНЕУРАЛЬСК: " Верхньоуральськ"
  ВЕРХНЕЯРКЕЕВО: "ВЕРХНЕЯРКЕЕВО "
  ? "ВЕРХНИЙ МАМОН"
  : " ВЕРХНІЙ МАМОНОВ "
  ? "ВЕРХНИЙ УСЛОН"
  : " ВЕРХНІЙ услони "
  ? "ВЕРХНИЙ УФАЛЕЙ"
  : " ВЕРХНІЙ Уфалей "
  ? "ВЕРХНЯЯ ПЫШМА"
  : " Верхньої Пишми "
  ВЕРХОВАЖЬЕ: " ВЕРХОВАЖЬЕ "
  ВЕРХОВИНА: " ВЕРХОВИНА "
  ВЕРХОВЬЕ: " ВЕРХОВЕ "
  ВЕРХОШИЖЕМЬЕ: " ВЕРХОШІЖЕМЬЕ "
  ВЕСЕЛИНОВО: " ВЕСЕЛИНОВЕ "
  ВЕСЕЛОЕ: " Веселі "
  ВЕСЕЛЫЙ: " ВЕСЕЛИЙ "
  ВЕСЬЕГОНСК: " Весьєгонську "
  ВЕТКА: " гілка "
  ВЕШЕНСКАЯ: " Вешенській "
  ВЕШКАЙМА: " ВЕШКАЙМА "
  ВЕЩЕВО: " Вещева "
  ВИЖНИЦА: " Вижниця "
  ВИЗИНГА: " ВІЗІНГА "
  ВИКУЛОВО: " Викулово "
  ВИЛЕЙКА: " Вілейка "
  ВИЛКАВИШКИС: " ВІЛКАВІШКІС "
  ВИЛЬНЮС: " ВІЛЬНЮС "
  ВИЛЬЯНДИ: " Вільянді "
  ВИЛЮЙСК: " Вілюйськ"
  ВИННИЦА: "ВІННИЦЯ "
  ВИНОГРАДОВ: " ВИНОГРАДОВ "
  ВИНЬКОВЦЫ: " Віньківці "
  ВИСКА: " ВИСКА "
  ВИТЕБСК: " ВІТЕБСЬК "
  ВИЧУГА: " ВІЧУГА "
  ВИШНЕВКА: " Вишнівка "
  ВЛАДИВОСТОК: " ВЛАДИВОСТОК "
  ВЛАДИМИР: " ВОЛОДИМИР "
  ВЛАДИМИР-АЛЕК: " ВОЛОДИМИР-АЛЕК "
  ВЛАДИМИР-ВОЛЫНС: " ВОЛОДИМИР-ВОЛИНС "
  ВЛАДИМИРЕЦ: " Володимирець "
  ВОЖЕГА: " Вожегов "
  ВОЗВЫШЕНКА: " ВОЗВИШЕНКА "
  ВОЗНЕСЕНСК: " Вознесенська "
  ВОЗНЕСЕНЬЕ: " ВОЗНЕСІННЯ "
  ВОЙСКОВИЦЫ: " ВОЙСКОВІЦИ "
  ВОЙСКОРОВО: " ВОЙСКОРОВО "
  ВОЛГОГРАД: " ВОЛГОГРАД "
  ВОЛГОДОНСК: " Волгодонськ "
  ВОЛГОРЕЧЕНСК: " ВОЛГОРЕЧЕНСК "
  ВОЛЖСК: " Волзько "
  ВОЛЖСКИЙ: " Волзький "
  ВОЛКОВЫСК: " Волковиську "
  ВОЛНОВАХА: " ВОЛНОВАХА"
  ВОЛОВО-ЛИПЕЦК: "Волово-ЛИПЕЦЬКА "
  ВОЛОВО-ТУЛА: " Волово-ТУЛА "
  ВОЛОГДА: " Вологда "
  ВОЛОДАР-ВОЛЫНСК: " Володар-Волинського "
  ВОЛОДАРКА: " ВОЛОДАРКА "
  ВОЛОДАРСКИЙ: " ВОЛОДАРСЬКИЙ "
  ВОЛОДАРСКОЕ-ДОН: " Володарськ-ДОН "
  ВОЛОДАРСКОЕ-КОК: " Володарськ-КОК "
  ВОЛОЖИН: " Воложин "
  ВОЛОКАЛАМСК: " ВОЛОКАЛАМСК "
  ВОЛОКОНОВКА: " Волоконовка "
  ВОЛОСОВО: " Волосова "
  ВОЛОЧИНСК: " Волочиськ "
  ВОЛУЙКИ: " ВОЛУЙКІ "
  ВОЛХОВ: " Волхов "
  ВОЛЧАНСК: " ВОВЧАНСЬКИЙ "
  ВОЛЧИХА: " Вовчиха "
  ВОЛЫНСК: " ВОЛИНСЬКІ "
  ВОЛЬНО-НАДЕЖДИН: " вільно-Надеждін "
  ВОЛЬНЯНСК: " ВІЛЬНЯНСЬКИЙ "
  ВОЛЬСК: " Власюк "
  ВОРКУТА: " ВОРКУТА "
  ВОРОБЬЕВКА: " Вороб&#39;ївка "
  ВОРОНЕЖ: " ВОРОНІЖ "
  ВОРОНОВО-ВОЛХОВ: " ВОРОНОВА-Волхов"
  ВОРОНОВО-ГРОДНО: "ВОРОНОВА-ГРОДНО "
  ВОРОТЫНЕЦ: " ВОРОТИНЕЦ "
  ВОСЕ: " ВОСЕ "
  ВОСКРЕСЕНСК: " ВОСКРЕСЕНСЬКА "
  ВОТКИНСК: " Воткинськ "
  ВРАДНЕВКА: " ВРАДНЕВКА "
  ВСЕВОЛЖСК: " ВСЕВОЛЖСК "
  ВУАДИЛЬ: " ВУАДІЛЬ "
  ВУКТЫЛ: " ВУКТИЛ "
  ВУЛКАНЕШТЫ: " Вулканешти "
  ВУРНАРЫ: " ВУРНАРИ "
  ВЫБОРГ: " Виборг "
  ВЫГОНИЧИ: " Вигоничі "
  ВЫКСА: " Викса "
  ВЫЛЬГОРТ: " ВИЛЬГОРТ "
  ВЫРИЦА: " Вириця "
  ВЫРУ: " Виру "
  ВЫСЕЛКИ: " Висілки "
  ВЫСКАТКА: " ВИСКАТКА "
  ? "ВЫСОКАЯ ГОРА"
  : " ВИСОКА ГОРА "
  ВЫСОКОПОЛЬЕ: " Високопілля "
  ВЫСОЦК: " ВИСОЦЬКУ "
  ВЫТЕГРА: " Витегра "
  ВЫШГОРОД: " ВИЖГОРОД "
  ? "ВЫШНИЙ ВОЛОЧЕК"
  : " Вишній Волочек"
  ВЯЗЕМСКИЙ: "Вяземський "
  ВЯЗНИКИ: " Вязники "
  ВЯЗЬМА: " Вязьма "
  ? "ВЯТСКИЕ ПОЛЯНЫ"
  : " вятскиє поляни "
  ГАВРИЛОВ-ПОСАД: " ГАВРИЛОВ-ПОСАД "
  ГАВРИЛОВ-ЯМ: " ГАВРИЛОВ-ЯМ "
  ГАВРИЛОВКА: " Гаврилівка "
  ГАВРИЛОВО: " ГАВРИЛОВА "
  ГАГАРИН-ДЖИЗАК: " ГАГАРІН-Джизак "
  ГАГАРИН-СМОЛЕНК: " ГАГАРІН-Смоленки "
  ГАГРЫ: " РОБОТИ "
  ГАДЯЧ: " ГАДЯЧ "
  ГАЗАКЕНТ: " ГАЗАКЕНТ "
  ГАЙВОРОН: " ГАЙВОРОН "
  ГАЙСИН: " ГАЙСИН "
  ГАЛААСИЯ: " ГАЛААСІЯ "
  ГАЛИЧ-И-ФРАНКОВ: " ГАЛИЧ-І-Франка "
  ГАЛИЧ-КОСТРОМА: " ГАЛИЧ-КОСТРОМА "
  ГАЛЯАРАЛ: " ГАЛЯАРАЛ "
  ГАНЦЕВИЧИ: " ганцевичі "
  ГАРГЖДАЙ: " ГАРГЖДАЙ "
  ГАСАН-КУЛИ: " Гасан-Кулі "
  ГАТЧИНА: " Гатчині "
  ГАФУРОВ: " Гафуров "
  ГВАРДЕЙСК: " ГВАРДІЙСЬКИЙ"
  ГВАРДЕЙСКОЕ: "Гвардійське "
  ГДОВ: " Гдов "
  ГЕЛЕНДЖИК: " Геленджик "
  ГЕНИЧЕСК: " ГЕНИЧЕСЬК "
  ГЕОК-ТЕПЕ: " Геоком-ТЕПЕ "
  ГЕОРГИЕВКА-ДЖАМ: " Георгіївка-Джам "
  ГЕОРГИЕВКА-СЕМИ: " Георгіївка-СЕМИ "
  ГЕОРГИЕВСК: " ГЕОРГІЄВСЬКИЙ "
  ГЕОРГИЕВСКОЕ: " ГЕОРГІЄВСЬКИЙ "
  ГЕОРГИУ-ДЕЖ: " Георгій-ДЕЖ "
  ГЕРГЧАЙ: " ГЕРГЧАЙ "
  ГИССАР: " Гісар "
  ГЛАБИНЕ: " ГЛАБІНЕ "
  ГЛАЖЕВО: " ГЛАЖЕВО "
  ГЛАЗОВ: " ГАЛУЗЕВЕ "
  ГЛАЗУНКОВКА: " ГЛАЗУНКОВКА "
  ГЛЕБЫЧЕВО: " ГЛЕБИЧЕВО "
  ГЛИНКА: " Глінки "
  ГЛОБИНО: " ГЛОБИНО "
  ГЛОДЯНЫ: " ГЛОДЯНИ "
  ГЛУБОКОЕ: " Глибока "
  ГЛУСК: " Глуськ "
  ГЛУХОВ: " ГЛУХІВ "
  ГЛУШКОВО: " Глушкова "
  ГЛЫБОКАЯ: " Глибока"
  ГЛЯДЯНСКОЕ: "ГЛЯДЯНСКОЕ "
  ГНИВАНЬ: " ГНІВАНЬ "
  ? "ГОЛАЯ ПРИСТАНЬ"
  : " ГОЛАЯ ПРИСТАНЬ "
  ГОЛИЦЫНО: " Голіцина "
  ГОЛОВАНЕВСК: " ГОЛОВАНІВСЬКИЙ "
  ГОЛЫШМАНОВО: " Голишманово "
  ГОМЕЛЬ: " ГОМЕЛЬ "
  ГОНЧАРОВО: " ГОНЧАРОВА "
  ГОНЬКОВО: " ГОНЬКОВО "
  ГОРБУНКИ: " ГОРБУНОК "
  ГОРДЕЕВКА: " Гордіївка "
  ГОРИ: " ГОРИ "
  ГОРИС: " Горіс "
  ГОРКИ: " ГІРКИ "
  ГОРЛОВКА: " ГОРЛІВКА "
  ГОРНО-АЛТАЙСК: " Горно-Алтайськ "
  ГОРНОЗАВОДСК: " Горнозаводськ "
  ГОРНОСТАЕВКА: " Горностаївка "
  ГОРНЫЙ: " ГІРСЬКИЙ "
  ГОРНЯК: " ГІРНИКИ "
  ГОРОДЕНКА: " ГОРОДЕНКА "
  ГОРОДЕЦ: " Городець "
  ГОРОДИЩЕ: " ГОРОДИЩЕ "
  ГОРОДНЯ: " ГОРОДНЯ "
  ГОРОДОК: " МІСТЕЧКО"
  ГОРОХОВ: "ГОРОХІВ "
  ГОРШЕЧНОЕ: " Кімнатні "
  ГОРЬКИЙ: " ГОРЬКИЙ "
  ГОРЬКИЙ-150: " ГОРЬКИЙ-150 "
  ГОРЬКОВСКОЕ: " Горьковський "
  ? "ГОРЯЧИЙ КЛЮЧ"
  : " ГАРЯЧИЙ КЛЮЧ "
  ГОС-76: " ГОС-76 "
  ГОСТИЛИЦЫ: " ГОСТІЛІЦИ "
  ГОСТИНОПОЛЬЕ: " ГОСТІНОПОЛЬЕ "
  ГОСТИЦЫ: " ГОСТІЦИ "
  ГОТВАЛЬД: " Готвальд "
  ГОЩА: " ГОЩА "
  ГРАХОВО: " Грахова "
  ГРАЧЕВКА: " ГРАЧЕВКА "
  ГРЕБЕНКА: " ГРЕБІНКА "
  ГРЕМЯЧИНСК: " ГРЕМЯЧІНСК "
  ГРЕС-19: " ГРЕС-19 "
  ГРИБАНОВСКИЙ: " Грибановський "
  ГРИГОРИОПОЛЬ: " Григоріополь "
  ГРОДНО: " ГРОДНО "
  ГРОЗНЫЙ: " Грозний "
  ГРОХОВЕЦ: " ГРОХОВЕЦ "
  ГРЯЗИ: " БРУДУ "
  ГРЯЗОВЕЦ: " Грязовець "
  ГУБАХА: " губах"
  ГУБКИН: "Губкін "
  ГУДЕРМЕС: " Гудермес "
  ГУЗАР: " ГУЗАР "
  ГУКОВО: " Гуков "
  ГУЛБИНЕ: " ГУЛБІНЕ "
  ГУЛИСТАН: " Гулістан "
  ГУЛЬБАХОР: " ГУЛЬБАХОР "
  ГУЛЬКЕВИЧИ: " Гулькевичі "
  ГУЛЯЙПОЛЕ: " ГУЛЯЙПОЛЕ "
  ГУРДЖААНИ: " Гурджаані "
  ГУРЛЕН: " ГУРЛЕН "
  ГУРЬЕВ: " Гур&#39;єв "
  ГУРЬЕВСК: " Гур&#39;євськ "
  ГУСЕВ: " ГУСЄВ "
  ГУСИНООЗЕРСК: " Гусиноозерськ "
  ? "ГУСЬ ХРУСТАЛЬНЫ"
  : " Гусь КРИШТАЛЕВИЙ "
  ГУСЯТИН: " ГУСЯТИН "
  ГЯНДЖА: " Гянджа "
  Д-КОНСТАНТИНОВО: " Д-КОНСТАНТИНОВА "
  ДАВЛЕКАНОВО: " Давлеканово "
  ДАЛМАТОВО: " Далматово "
  ДАЛЬНЕГОРСК: " Дальнегорська "
  ДАЛЬНЕРЕЧЕНСК: " дальнєреченськ "
  ДАНГАРА: " ДАНГАРА "
  ДАНИЛОВ: " ДАНИЛОВ"
  ДАНИЛОВКА: "Данилівка "
  ДАНКОВ: " Данко "
  ДАРГАН-АТА: " ДАРГАН-АТА "
  ДАРЬИНСКОЕ: " ДАРЬІНСКОЕ "
  ДАУГАВПИЛС: " ДАУГАВПІЛС "
  ДВУРЕЧНАЯ: " Дворічна "
  ДЕБАЛЬЦЕВО: " ДЕБАЛЬЦЕВЕ "
  ДЕБЕССЫ: " ДЕБЕССИ "
  ДЕДОВИЧИ: " Дедович "
  ДЕМИДОВ: " ДЕМИДОВ "
  ДЕМЯНСК: " Дем&#39;янська "
  ДЕНАУ: " днів "
  ДЕРАЖНЯ: " ДЕРАЖНЯ "
  ДЕРГАЧИ: " ДЕРГАЧОВ "
  ? "ДЕРГАЧИ САРАТ"
  : " ДЕРГАЧОВ САРАТА "
  ДЕРЖАВИНСК: " Державінська "
  ДЕСНОГОРСК: " ДЕСНОГОРСК "
  ДЖАЛАЛ-АБАД: " Джалал-Абад "
  ДЖАЛИЛАБАД: " ДЖАЛІЛАБАД "
  ДЖАМБАЙ: " ДЖАМБАЙ "
  ДЖАМБЕЙТЫ: " ДЖАМБЕЙТИ "
  ДЖАМБУЛ: " Джамбул "
  ДЖАНКОЙ: " ДЖАНКОЙ "
  ДЖАНСУГУРОВО: " ДЖАНСУГУРОВО "
  ДЖАНЫБЕК: " ДЖАНИБЕК"
  ДЖЕЗКАЗГАН: "Джезказган "
  ДЖЕРМУК: " Джермук "
  ДЖЕТЫГАРА: " Джетигара "
  ДЖЕТЫСАЙ: " ДЖЕТИСАЙ "
  ДЖИЗАК: " Джизак "
  ДЖИЛККУЛЬ: " ДЖІЛККУЛЬ "
  ДЖИРГИТАЛЬ: " ДЖІРГІТАЛЬ "
  ДЖУМА: " Джума "
  ДЖУМАШУЙ: " ДЖУМАШУЙ "
  ДЗЕРЖИНСК: " ДЗЕРЖИНСЬК "
  ДИВЕЕВО: " Дівєєва "
  ДИВНОГОРСК: " Дивногорський "
  ДИВНОЕ: " Дивно "
  ДИГОРА: " Дігора "
  ДИКАНЬКА: " ДИКАНЬКА "
  ДИЛИЖАН: " ДІЛІЖАН "
  ДИМИТРОВОГРАД: " ДІМІТРОВОГРАД "
  ДИНСКАЯ: " Дінська "
  ДМИТРИЕВ: " ДМИТРІЄВ "
  ДМИТРИЕВКА: " Дмитрівка "
  ДМИТРОВ: " Дмитро "
  ДМИТРОВСКОЕ: " Дмитрівська "
  ДНЕПРОДЗЕРЖИНСК: " ДНІПРОДЗЕРЖИНСЬК "
  ДНЕПРОПЕТРОВСК: " ДНІПРОПЕТРОВСЬК "
  ДНЕПРОРУДНЫЙ: " Дніпрорудне"
  ДОБЕЛЕ: "Добеле "
  ДОБРИНКА: " Добринко "
  ДОБРОВЕЛИЧКОВКА: " Добровеличківка "
  ДОБРОЕ: " Добрий "
  ДОБРОПОЛЬЕ: " Добропілля "
  ДОБРУШ: " Добруш "
  ДОВОЛЬНОЕ: " ПОВНІСТЮ "
  ДОКУЧАЕВКА: " ДОКУЧАЕВКА "
  ДОКУЧАЕВСК: " Докучаєвськ "
  ДОКШИЦЫ: " Докшиці "
  ДОЛГОДЕРЕВЕНСК.: " ДОЛГОДЕРЕВЕНСК. "
  ДОЛГОЕ: " Боргу "
  ДОЛГОРУКОВО: " Долгорукова "
  ДОЛИНА: " ДОЛИНА "
  ДОЛИНСК: " ДОЛИНСЬКА "
  ДОЛИНСКАЯ: " ДОЛИНСЬКА "
  ДОМАСАКА: " ДОМАСАКА "
  ДОМОДЕДОВО: " Домодєдово "
  ДОНДЮШАНЫ: " ДОНДЮШАНИ "
  ДОНЕЦК: " ДОНЕЦЬК "
  ДОНЕЦК-РОСТ-ДОН: " ДОНЕЦЬК-РОСТ-ДОН "
  ДОНЕЦКОЕ: " ДОНЕЦЬКЕ "
  ДОРОГОБУШ: " ДОРОГОБУШ "
  ДРАБОВ: " Драбів "
  ДРОГИЧИН: " Дрогичин"
  ДРОГОБЫЧ: "ДРОГОБИЧ "
  ДРОКИЯ: " Дрок "
  ДРУЖБА: " ДРУЖБА "
  ДРУЖКОВКА: " ДРУЖКІВКА "
  ДРУСКИНИНКАЙ: " Друскінінкай "
  ДУБЕНКИ: " Дубенко "
  ДУБНА: " ДУБНА "
  ДУБНО: " ДУБНО "
  ДУБОВКА: " Дубівка "
  ДУБОССАРЫ: " Дубоссар "
  ДУБРОВИЦА: " ДУБРОВИЦЯ "
  ДУБРОВКА: " Дубровці "
  ДУБРОВНО: " Дубровни "
  ДУЛЬДУРГА: " ДУЛЬДУРГА "
  ДУМБРАВЕНЫ: " Думбрава "
  ДУМИНИЧИ: " думиничі "
  ДУНАЕВЦЫ: " ДУНАЇВЦІ "
  ДУРЛЕШТЫ: " ДУРЛЕШТИ "
  ДУСТИ: " ДУСТ "
  ДУХОВНИЦКОЕ: " ДУХОВНІЦКОЕ "
  ДУХОВЩИНА: " ДУХОВЩІНА "
  ДУШАНБЕ: " ДУШАНБЕ "
  ДУШЕТИ: " ДУШЕТІ "
  ДЫЛЫМ: " ДИЛИМ "
  ДЮРТЮЛИ: " ДЮРТЮЛІ"
  ДЯТЛОВО: "Дятлова "
  ДЯТЬКОВО: " Дятьково "
  ЕВЛАХ: " ЄВЛАХ "
  ЕВПАТОРИЯ: " ЄВПАТОРІЯ "
  ЕГВАРД: " ЕГВАРД "
  ЕГИНДЫБУЛЫК: " ЕГІНДИБУЛИК "
  ЕГОРЛЫК: " Єгорлик "
  ЕГОРЬЕВСК: " Єгорьєвськ "
  ЕДИНЦЫ: " ЕДІНЦИ "
  ЕЖЕГНАДЗОР: " ЕЖЕГНАДЗОР "
  ЕЙСК: " ЄЙСЬК "
  ЕКАБПИЛС: " Єкабпілс "
  ЕКАТЕРИНОВКА: " Катеринівка "
  ЕЛАБУГА: " ЕЛАБУГА "
  ЕЛАНЕЦ: " Єланець "
  ЕЛАНЬ: " Елан "
  ЕЛГАВА: " Елгава "
  ЕЛЕЦ: " Єлець "
  ЕЛИЗОВО: " Елизово "
  ЕЛОВО: " ялиново "
  ЕЛЬНИКИ: " Єльник "
  ЕЛЬНЯ: " Єльня "
  ЕЛЬСК: " Єльськ "
  ЕЛЬЦОВКА: " ЕЛЬЦОВКА "
  ЕМАНЖЕЛИНСК: " єманжелинск"
  ЕМВА: "ЕМВА "
  ЕМЕЛЬЧИНО: " ЕМЕЛЬЧІНО "
  ЕМЕЛЬЯНОВО: " Ємельянова "
  ЕНАКИЕВО: " ЄНАКІЄВО "
  ЕНИСЕЙСК: " ЄНІСЕЙСЬКА "
  ЕНОТАЕВКА: " ЕНОТАЕВКА "
  ЕРЕВАН: " ЄРЕВАН "
  ЕРМАК: " ЄРМАК "
  ЕРМАКОВСКОЕ: " Ермаковский "
  ЕРМЕНТАУ: " єрментау "
  ЕРМИШЬ: " ЕРМІШЬ "
  ЕРШИЧИ: " ЕРШІЧІ "
  ЕРШОВ: " ЄРШОВ "
  ЕСИЛЬ: " єсиль "
  ЕССЕНТУКИ: " Єсентуки "
  ЕТКУЛЬ: " ЕТКУЛЬ "
  ЕФРЕМОВ: " ЄФРЕМОВ "
  ЕХЕГНАДЗОР: " ЕХЕГНАДЗОР "
  ЖАБИНКА: " Жабинка "
  ЖАНАТАС: " Жанатас "
  ЖАШКОВ: " Жашків "
  ЖЕЛЕЗИНКА: " ЖЕЛЕЗІНКА "
  ЖЕЛЕЗНОВОДСК: " Желєзноводськ "
  ЖЕЛЕЗНОГ.-КУРСК: " ЖЕЛЕЗНОГ.-курськ "
  ЖЕЛЕЗНОГОРСК-ИР: " Железногорськ-ІР"
  ЖЕЛТЫЕ-ВОДЫ: "ЖОВТІ-ВОДИ "
  ЖЕРДЕВКА: " Жердевка "
  ЖИГУЛЕВСК: " Жигульовськ "
  ЖИДАЧОВ: " ЖИДАЧІВ "
  ЖИЗДРА: " Жиздра "
  ЖИРНОВСК: " ЖІРНОВСК "
  ЖИРЯТИНО: " ЖІРЯТІНО "
  ЖИТКОВИЧИ: " ЖИТОМИР "
  ЖИТКОВО: " ЖИТКОВА "
  ЖИТОМИР: " ЖИТОМИР "
  ЖИХАРЕВО: " Жихарева "
  ЖЛОБИН: " ЖЛОБИН "
  ЖМЕРИНКА: " ЖМЕРИНКА "
  ЖОДИНО: " Жодіно "
  ЖОНДОР: " ЖОНДОР "
  ЖУКОВКА: " ЖУКОВКА "
  ЖУКОВО: " ЖУКОВ "
  ЖУКОВСКИЙ: " ЖУКОВСЬКИЙ "
  ЗААМИН: " ЗААМІН "
  ЗАБАЙКАЛЬСК: " забайкальск "
  ЗАВЕТНОЕ: " Заповітна "
  ЗАВОДОУКОВСК: " ЗАВОДОУКОВСК "
  ЗАВОЛЖЬЕ: " Заволжя "
  ЗАВЬЯЛОВО-БАРН.: " Завьялова - Барна. "
  ЗАВЬЯЛОВО-УСТИН: " Завьялова-УСТІНОВ"
  ЗАГОРСК: "ЗАГОРСЬКА "
  ЗАГРИВЬЕ: " Загрива "
  ЗАДОНСК: " Задонськ "
  ЗАИГРАЕВО: " заіграєво "
  ЗАИНСК: " Заїнська "
  ЗАЙСАН: " Зайсан "
  ЗАКАМЕНСК: " ЗАКАМЕНСК "
  ЗАКАТЫЛЫ: " ЗАКАТИЛИ "
  ЗАЛАРИ: " залари "
  ЗАЛЕГОЩЬ: " ЗАЛЕГОЩЬ "
  ЗАЛЕЖИКИ: " ЗАЛЕЖІКІ "
  ЗАЛЕСОВО: " ЗАЛЕСОВО "
  ЗАЛУКОКАЖЕ: " ЗАЛУКОКАЖЕ "
  ЗАОЗЕРНЫЙ: " Заозерне "
  ЗАОКСКИЙ: " ЗАОКСКІЙ "
  ? "ЗАПАДНАЯ ДВИНА"
  : " ЗАХІДНА ДВИНА "
  ЗАПОЛЯРНЫЙ: " Заполярная "
  ЗАПОРОЖЬЕ: " ЗАПОРІЖЖЯ "
  ЗАРАЙСК: " Зарайськ "
  ЗАРАСАЙ: " Зарасай "
  ЗАРЕЧНОЕ: " ЗАРІЧНЕ "
  ЗАРИНСК: " ЗАРІНСК "
  ЗАСТАВНА: " ЗАСТАВНА "
  ЗАТОБОЛЬСК: " ЗАТОБОЛЬСК "
  ЗАФАР: " Зафар"
  ЗАФАРОБАД: "ЗАФАРОБАД "
  ЗАЧЕПИЛОВКА: " Зачепилівка "
  ЗБАРАШ: " ЗБАРАШ "
  ЗБОРОВ: " ЗБОРИ "
  ЗВЕНИГОВО: " ЗВЕНІГОВО "
  ЗВЕНИГОРОД: " Звенигород "
  ЗВЕНИГОРОДКА: " ЗВЕНИГОРОДКА "
  ЗГУРОВКА: " Згурівка "
  ЗДВИНСК: " ЗДВІНСК "
  ЗДОЛБУНОВ: " ЗДОЛБУНІВ "
  ЗЕЛЕНОГРАДСК: " Зеленоградськ "
  ЗЕЛЕНОДОЛЬСК: " Зеленодольськ "
  ЗЕЛЕНЧУКСКАЯ: " ЗЕЛЕНЧУКСКАЯ "
  ЗЕЛЬВА: " Зельва "
  ЗЕМЕТЧИНО: " ЗЕМЕТЧІНО "
  ЗЕНЬКОВ: " Зіньків "
  ЗЕРЕНДА: " ЗЕРЕНДА "
  ЗЕРНОГРАД: " Зерноград "
  ЗИАДИН: " ЗІАДІН "
  ЗИМА-ИРКУТСК: " ЗИМА-ІРКУТСЬК "
  ЗИМОВНИКИ: " Замовник "
  ЗЛАТОУСТ: " ЗЛАТОУСТ "
  ЗМЕИНОГОРСК: " ЗМЕІНОГОРСК "
  ЗМИЕВКА: " Зміївка "
  ЗНАМЕНКА-КИРОВО: " знам&#39;янка-КІРОВ"
  ЗНАМЕНКА-ТАМБОВ: "Знам&#39;янка-ТАМБОВ "
  ЗНАМЕНСКОЕ-ГРОЗ: " ЗНАМ&#39;ЯНСЬКА-ГРОЗ "
  ЗНАМЕНСКОЕ-ОМСК: " ЗНАМ&#39;ЯНСЬКА-Омськ "
  ЗОЛОТОНОША: " ЗОЛОТОНОША "
  ЗОЛОТУХИНО: " ЗОЛОТУХІН "
  ЗОЛОЧЕВ-ЛЬВОВ: " ЗОЛОЧІВ-ЛЬВІВ "
  ЗОЛОЧЕВ-ХАРЬКОВ: " ЗОЛОЧІВ-ХАРКІВ "
  ЗОНАЛЬНОЕ: " Зустріч "
  ? "ЗУБОВА ПОЛЯНА"
  : " ЗУБОВА ПОЛЯНА "
  ЗУБЦОВ: " ЗУБЦЯ "
  ЗУЕВКА: " Зуївка "
  ЗЫРЯНОВСК: " Зиряновська "
  ЗЫРЯНСКОЕ: " ЗИРЯНСКОЕ "
  ИБРЕСИ: " ібреси "
  ИВАНГОРОД: " Івангород "
  ИВАНИЧИ: " Іваничі "
  ИВАНКОВ: " Іванків "
  ИВАНО-АЛЕКСЕЕВК: " ІВАНО-ОЛЕКСІЇВКА "
  ИВАНО-ФРАНКОВСК: " ІВАНО -ФРАНКІВСЬК "
  ИВАНОВКА: " ІВАНІВКА "
  ИВАНОВКА-ОДЕССА: " ІВАНІВКА-ОДЕССА "
  ИВАНОВКА-ФРУНЗЕ: " ІВАНІВКА-ФРУНЗЕ "
  ИВАНОВКА-ХЕРСОН: " ІВАНІВКА-ХЕРСОН "
  ИВАНОВО: " ІВАНОВА "
  ИВАНОВО-БРЕСТ: " Іванова-БРЕСТ"
  ИВАНТЕЕВКА: "Івантєєвка "
  ИВАНЦЕВИЧИ: " Іванцевичі "
  ИВНЯ: " ІВНЯ "
  ИВОЛГИНСК: " Іволгінськ "
  ИВЬЕ: " ІВЬЕ "
  ИГЛИНО: " Ігліно "
  ИГНАЛИНА: " Ігналіна "
  ИГРА: " ГРА "
  ИДЖЕВАН: " Іджеван "
  ИДРИНСКОЕ: " ІДРІНСКОЕ "
  ИЕЕТСКОЕ: " ІЕЕТСКОЕ "
  ИЖЕВСК: " ІЖЕВСЬК "
  ИЖМА: " ІЖМА "
  ИЖМОРСКИЙ: " ІЖМОРСКІЙ "
  ИЗМАИЛ: " ІЗМАЇЛ "
  ИЗМАЛКОВО: " ІЗМАЛКОВО "
  ИЗОБИЛЬНЫЙ: " Ізобільне "
  ИЗЮМ: " ІЗЮМ "
  ИЗЯСЛАВ: " Ізяслав "
  ИКИ-БУРУЛ: " ІКД-Буруль "
  ИКРЯНОЕ: " ІКРЯНОЕ "
  ИЛАНСКИЙ: " іланська "
  ИЛЕК: " ІЛЕК "
  ИЛОВАЙСК: " ІЛОВАЙСЬК "
  ИЛОВЛЯ: " ІЛОВЛЯ"
  ИЛЬИНСКИЙ: "Іллінська "
  ИЛЬИНСКО-ПОДОМС: " Іллінська-ПОДОМС "
  ИЛЬИНСКОЕ-ХАВАН: " Іллінська-Хава "
  ИЛЬИНЦЫ: " Іллінці "
  ИЛЬЯЛЫ-ТАШАУЗ: " Ільяли-ТАШАУЗ "
  ИМАНЬ: " Іман "
  ИНЗА: " Інза "
  ИНСАР: " Інсаров "
  ИНТА: " ІНТА "
  ИОЛОТАНЬ: " Іолотань "
  ИОНАВА: " ІОНАВА "
  ИОНИШКИС: " ІОНІШКІС "
  ИПАТОВО: " Іпатова "
  ИРБЕЙСКОЕ: " ІРБЕЙСКОЕ "
  ИРБИТ: " Ирбит "
  ИРИНОВКА: " ІРІНОВКА "
  ИРКУТСК: " ІРКУТСЬК "
  ИРПЕНЬ: " ІРПІНЬ "
  ИРТЫШСК: " іртишських "
  ИРШАВА: " ІРШАВА "
  ИСАКЛЫ: " ІСАКЛИ "
  ИСЕТСКОЕ: " Ісетським "
  ИСИЛЬКУЛЬ: " ісилькуль "
  ИСКИТИМ: " ІСКІТІМ "
  ИСМАИЛЛЫ: " ІСМАІЛЛИ"
  ИССЫК: "Іссик "
  ИСТРА: " ІСТРА "
  ИСФАНА: " ІСФАНА "
  ИСФАРА: " Ісфара "
  ИСЯНГУЛОВО: " ІСЯНГУЛОВО "
  ИТЫК-КЮЕЛЬ: " ІТИК-КЮЕЛЬ "
  ИЧНЯ: " ІЧНЯ "
  ИШЕЕВКА: " ІШЕЕВКА "
  ИШИМБАЙ: " Ішимбай "
  ИШТЫХАН: " ІШТИХАН "
  ЙОШКАР-ОЛА: " Йошкар-Ола "
  ЙЫГЕВА: " Йигева "
  КААХКА: " КААХКА "
  КАВАЛЕРОВО: " Кавалерів "
  КАВКАЗСКАЯ: " КАВКАЗСЬКА "
  КАГАЛЬНИЦКАЯ: " КАГАЛЬНІЦКАЯ "
  КАГАН: " Каган "
  КАГАРЛЫК: " Кагарлик "
  КАГУЛ: " Кагул "
  КАДОМ: " Кадом "
  КАДУЙ: " Кадуй "
  КАДЫЙ: " КАДИЙ "
  КАЗАНДЖИК: " КАЗАНДЖІК "
  КАЗАНКА: " КАЗАНКА "
  КАЗАНСКОЕ: " КАЗАНСЬКОГО"
  КАЗАНЬ: "КАЗАНЬ "
  КАЗАРМАН: " КАЗАРМАН "
  КАЗАТИН: " КАЗАТІН "
  КАЗАХ: " Казах "
  КАЗАЧИНСКОЕ: " Казачинське "
  КАЗТАЛОВКА: " КАЗТАЛОВКА "
  КАИНДА: " КАІНДА "
  КАЙРАККУМ: " КАЙРАККУМ "
  КАЙШЯДОРИС: " КАЙШЯДОРІС "
  КАЛАНЧАК: " КАЛАНЧАК "
  КАЛАРАШ: " Калараш "
  КАЛАЧ: " КАЛАЧ "
  ? "КАЛАЧ НА ДОНУ"
  : " КАЛАЧ НА ДОНУ "
  КАЛАЧИНСК: " Калачинськ "
  КАЛГА: " Калга "
  КАЛЕВАЛА: " Калевала "
  КАЛИНИН: " КАЛІНІН "
  КАЛИНИНГРАД: " КАЛІНІНГРАД "
  КАЛИНИНО: " КАЛІНІНА "
  КАЛИНИНСКАЯ: " Калінінський "
  КАЛИНКОВИЧИ: " Калинковичі "
  КАЛИНОВКА: " КАЛИНІВКА "
  КАЛМАНКА: " КЛИМЕНКО "
  КАЛУГА: " КАЛУГА "
  КАЛУШ: " КАЛУШ"
  КАЛЯЗИН: "Калязин "
  КАМ-КАШИРСКИЙ: " КАМ-Каширський "
  КАМАШИ: " Камаша "
  КАМБАРКА: " камбарка "
  КАМЕНЕЦ: " КАМ&#39;ЯНЕЦЬ "
  КАМЕНЕЦ-ПОДОЛЬС: " КАМ&#39;ЯНЕЦЬ-ПОДІЛЬСЬКИЙ "
  КАМЕНКА: " КАМ "
  КАМЕНКА-БУГСКАЯ: " КАМ-Бузька "
  КАМЕНКА-ВОРОНЕЖ: " КАМ-ВОРОНІЖ "
  КАМЕНКА-ДНЕПР: " КАМ-ДНЕПР "
  КАМЕНКА-КИШИНЕВ: " КАМ-КИШИНІВ "
  КАМЕНКА-ТОСНО: " КАМ-ТОСНО "
  КАМЕНКА-УРАЛЬСК: " КАМ-Уральський "
  КАМЕНКА-ЧЕРКАСС: " КАМ-ЧЕРКАСС "
  КАМЕНОГОРСК: " Каменогорськ "
  КАМЕНОЛОМНЯ: " Каменоломні "
  КАМЕНСК: " Каменських "
  КАМЕНСК-УРАЛЬСК: " Каменськ-Уральський "
  КАМЕНЬ-НА-ОБИ: " КАМІНЬ-НА-ОБІ "
  КАМЕНЬ-РЫБОЛОВ: " КАМІНЬ-рибалка "
  КАМЕШКОВО: " КАМЕШКОВО "
  КАМО: " КАМО "
  ? "КАМСКОЕ УСТЬЕ"
  : " Камський гирлі "
  КАМЫЗЯК: " Камизяк "
  КАМЫШЕВКА: " очеретянка"
  КАМЫШИН: "Камишин "
  КАМЫШНОЕ: " Комишне "
  КАНАШ: " Канаш "
  КАНГОЛАСЫ: " КАНГОЛАСИ "
  КАНДАЛАКША: " Кандалакша "
  КАНЕВ: " КАНІВ "
  КАНЕВСКАЯ: " КАНЕВСЬКА "
  КАНЕМИР: " КАНЕМІР "
  КАНИБАДАМ: " Канібадам "
  КАНИМЕХ: " КАНІМЕХ "
  КАНСК: " Канськ "
  КАНТ: " КАНТ "
  КАНТЕМИР: " Кантеміра "
  КАНТЕМИРОВКА: " Кантемировку "
  КАПАЛ: " КАПА "
  ? "КАПУСТИН ЯР"
  : " КАПУСТІН ЯР "
  КАПЧАГАЙ: " Капчагай "
  КАРА-БАЛТА: " КАРА-БАЛТА "
  КАРА-КАЛА: " КАРА-Кала "
  КАРА-СУУ: " КАРА-Суу "
  КАРАБЕКАУЛ: " КАРАБЕКАУЛ "
  КАРАБУДАХКЕНТ: " КАРАБУДАХКЕНТ "
  КАРАБУЛАК: " Карабулак "
  КАРАВАН: " КАРАВАН "
  КАРАГАЙ: " Карагай"
  КАРАГАЙЛЫ: "КАРАГАЙЛИ "
  КАРАГАЛИНСКОЕ: " КАРАГАЛІНСКОЕ "
  КАРАГАНДА: " КАРАГАНДА "
  КАРАЖАЛ: " Каражал "
  КАРАИДЕЛЬ: " КАРАІДЕЛЬ "
  КАРАКУЛИНО: " Каракулін "
  КАРАКУЛЬ-БУХАРА: " Каракуль-Бухарі "
  КАРАКУЛЬ-ТАЛАС: " Каракуль-Талас "
  КАРАКУШЧИ: " КАРАКУШЧІ "
  КАРАСУ: " КАРАСЬОВ "
  КАРАСУК: " Карасук "
  КАРАТОБЕ: " КАРАТОБЕ "
  КАРАТУЗСКОЕ: " КАРАТУЗСКОЕ "
  КАРАУЗЯК: " КАРАУЗЯК "
  КАРАУЛ-СЕМИПАЛА: " КАРАУЛ-СЕМІПАЛА "
  КАРАУЛ-УРГЕНЧ: " КАРАУЛ-Ургенч "
  КАРАЧЕВ: " КАРАЧІ "
  КАРГАПОЛЬЕ: " Каргаполов "
  КАРГАСОК: " КАРГАСОК "
  КАРГАТ: " каргат "
  КАРДЫМОВО: " КАРДИМОВО "
  КАРКАРАЛИНСК: " КАРКАРАЛІНСК "
  КАРЛОВКА: " КАРЛІВКА "
  КАРМАНА: " КИШЕНІ "
  КАРМАСКАЛЫ: " КАРМАСКАЛИ"
  КАРПИНСК: "КАРПІНСЬКИЙ "
  КАРСУН: " КАРСУН "
  КАРТАЛЫ: " картали "
  КАРШИ: " КАРШЕ "
  КАРЫМСКОЕ: " КРИМСЬКА "
  КАСАН: " КАСАН "
  КАСАНСАЙ: " КАСАНСАЙ "
  КАСИМОВ: " Касим "
  КАСКЕЛЕН: " Каскелен "
  КАСЛОВКА: " КАСЛОВКА "
  КАСЛЫ: " Касл "
  КАСПИ: " КАСП "
  КАСПИЙСКИЙ: " КАСПІЙСЬКОГО "
  КАСТОРНОЕ: " касторна "
  КАТАВ-ИВАНОВСК: " КАТА-Іванівського "
  КАТАЙСК: " Катайськ "
  КАТЕРИНОПОЛЬ: " Катеринопіль "
  КАТОВО: " катів "
  КАТОН: " Катон "
  КАТТАКУРГАН: " Каттакургана "
  КАУНАС: " КАУНАС "
  КАУШАНЫ: " Каушан "
  КАФАН: " КАФА "
  КАХОВКА: " КАХОВКА "
  КАЧИРЫ: " КАЧІРИ"
  КАЧКАНАР: "Качканар "
  КАШИН: " КАШИН "
  КАШИРА: " Кашира "
  КАШИРСКОЕ: " КАШИРСЬКА "
  КБАН: " КБАН "
  КЕГЕЙЛИ: " КЕГЕЙЛІ "
  КЕГЕНЬ: " КЕГЕНЬ "
  КЕГИЧЕВКА: " Кегичівка "
  КЕДАЙНЯЙ: " Кедайняй "
  КЕЛЕС: " КЕЛЕС "
  КЕЛЛЕРОВКА: " КЕЛЛЕРОВКА "
  КЕЛЬМЕ: " Кельма "
  КЕЛЬМЕНЦЫ: " Кельменці "
  КЕМЕРОВО: " КЕМЕРОВО "
  КЕМЛЯ: " КЕМЛЯ "
  КЕМЬ: " Кемь "
  КЕНТАУ: " Кентау "
  КЕРЧЬ: " КЕРЧ "
  КЕТОВО-ГОРЬКИЙ: " Кетов-ГОРЬКИЙ "
  КЕТОВО-КУРГАН: " Кетов-КУРГАН "
  КЗЫЛ-ОРДА: " Кзил-Орда "
  КЗЫЛТУ: " КЗИЛТУ "
  КИБРАЙ: " КІБРАЙ "
  КИВЕРЦЫ: " КІВЕРЦІ "
  КИЕВ: " КИЇВ"
  КИЕВКА: "Київка "
  КИЖИНГА: " КОЖНОГО "
  КИЗЕЛ: " Кізел "
  КИЗИЛ-АТРЕК: " Кизил-Атрек "
  КИЗИЛЬСКОЕ: " КІЗІЛЬСКОЕ "
  КИЗНЕР: " кизнер "
  КИЗЫЛ-АРВАТ: " Кизил-Арват "
  КИЙМА: " КІЙМА "
  КИКВИДЗЕ: " КІКВІДЗЕ "
  КИКЕРИНО: " КІКЕРІНО "
  КИЛЕМАРЫ: " КІЛЕМАРИ "
  КИЛИЯ: " Кілія "
  КИМОВСК: " Кимовського "
  КИМРЫ: " Кімри "
  КИНГИСЕПП: " Кінгісепп "
  КИНЕЛЬ: " кинель "
  КИНЕЛЬ-ЧЕРКАССЫ: " кинель-ЧЕРКАСИ "
  КИНЕШМА: " Кінешмі "
  КИПЕНЬ: " Кипень "
  КИРГИЗ-МИЯКИ: " КИРГИЗІЇ-Міякі "
  КИРЕЕВСК: " Киреевский "
  КИРЕНСК: " Кіренська "
  КИРЖАЧ: " Киржач "
  КИРИЛЛОВ: " КИРИЛЛОВ "
  КИРИШИ: " Кирішах"
  КИРИШСКИЙ-НЕФЗА: "Кіришської-НЕФЗА "
  КИРОВ: " КІРОВ "
  КИРОВ-КАЛУГА: " КІРОВ-КАЛУГА "
  КИРОВАКАН: " Кіровакан "
  КИРОВКА: " Кіровка "
  КИРОВО: " КІРОВА "
  КИРОВОГРАД-СВРД: " КІРОВОГРАД-СВРД "
  КИРОВОГРАД-УАК2: " КІРОВОГРАД-УАК2 "
  КИРОВОЧЕПЕЦК: " КІРОВОЧЕПЕЦК "
  КИРОВСК: " Кіровський "
  КИРОВСКИЙ: " КИРОВСЬКИЙ "
  КИРОВСКОЕ: " Кіровське "
  КИРОВСКОЕ.: " Кіровське. "
  КИРПИЧНОЕ: " ЦЕГЛЯНОЇ "
  КИРСАНОВ: " Кірсанов "
  КИСИЛЕВСК: " Кисілевська "
  КИСЛОВОДСК: " КИСЛОВОДСЬК "
  КИТАБ: " Кітаб "
  КИЦМАНЬ: " КІЦМАНЬ "
  ? "КИЧМЕНГСКИЙ ГОР"
  : " КІЧМЕНГСКІЙ ГОР "
  КИШИНЕВ: " КИШИНІВ "
  КИЯСОВО: " КІЯСОВО "
  КЛАЙПЕДА: " КЛАЙПЕДА "
  КЛЕТНЯ: " КЛЕТНЯ "
  КЛЕТСКИЙ: " Клетській"
  КЛЕЦК: "Клецьк "
  КЛИМОВИЧИ: " КЛИМОВИЧ "
  КЛИМОВО-БРЯНСК: " КЛИМОВА-БРЯНСЬК "
  КЛИМОВО-ВЫБОРГ: " КЛИМОВА-Виборг "
  КЛИН: " КЛИН "
  КЛИНЦЫ: " Калинець "
  КЛИЧЕВ: " КЛИЧ "
  КЛЮЧИ: " КЛЮЧІ "
  КЛЯВЛИНО: " КЛЯВЛІНО "
  КОБЕЛЯКИ: " КОБЕЛЯКИ "
  КОБРИН: " Кобрин "
  КОВДОР: " КОВДРОЮ "
  КОВЕЛЬ: " КОВЕЛЬ "
  КОВЕРНИНО: " КОВЕРНІНО "
  КОВРОВ: " КИЛИМІВ "
  КОВЫЛКИНО: " КОВИЛКІНО "
  КОДЫМА: " КОДИМА "
  КОЗЕЛЕЦ: " КОЗЕЛЕЦЬ "
  КОЗЕЛЬСК: " Козельськ "
  КОЗЕЛЬЩИНА: " КОЗЕЛЬЩИНА "
  КОЗЛОВКА: " Козлівка "
  КОЗОВА: " КОЗОВА "
  КОЗТАЛОВКА: " КОЗТАЛОВКА "
  КОЗУЛЬКА: " Козулько "
  КОЗЬМОДЕМЬЯНСК: " Козьмодем&#39;янськ"
  КОЙГОРОДОК: "Койгородок "
  КОКАНД-ТАШКЕНТ: " Коканд-ТАШКЕНТ "
  КОКАНД-ФЕРГАНА: " Коканд-Фергана "
  КОКПЕКТЫ: " кокпекти "
  КОКЧЕТАВ: " Кокчетав "
  КОЛА: " КОЛА "
  КОЛОГРИВ: " Кологрив "
  КОЛОМНА: " Коломна "
  КОЛОМЫЯ: " КОЛОМИЯ "
  КОЛОСОВКА: " Колосівка "
  КОЛПАШЕВО: " Колпашево "
  КОЛПНА: " КОЛПНА "
  КОЛТОН: " Колтона "
  КОЛХОЗОБАД: " КОЛХОЗОБАД "
  КОЛЧАНОВО: " Колчанова "
  КОЛЫВАНЬ: " КЛОВНЯ "
  КОЛЫШЛЕЙ: " колишлей "
  КОЛЬЧУГИНО: " Кольчугино "
  КОМАРИЧИ: " КОМАРІЧІ "
  ? "КОМБИНАТ ФОСФОР"
  : " КОМБІНАТ ФОСФОРУ "
  КОМИНТЕРНОВСК: " КОМІНТЕРНІВСЬКИЙ "
  КОММУНАР: " КОМУНАР "
  КОММУНАРСК: " Комунарськ "
  КОММУНИСТИЧЕСКЙ: " КОМУНІСТИЧНОЇ "
  КОМПАНЕЕВКА: " Компаніївка"
  КОМРАТ: "Комрат "
  КОМСОМОЛЕЦ: " КОМСОМОЛЕЦЬ "
  КОМСОМОЛОБАД: " КОМСОМОЛОБАД "
  КОМСОМОЛЬСК: " КОМСОМОЛЬСЬК "
  КОМСОМОЛЬСКИЙ: " КОМСОМОЛЬСКИЙ "
  КОМСОМОЛЬСКОЕ: " КОМСОМОЛЬСЬКЕ "
  КОНАКОВО: " Конакова "
  КОНДИНСКОЕ: " КОНДІНСКОЕ "
  КОНДОПОГА: " Кондопога "
  КОНДРОВО: " Кондрово "
  КОНОТОЛ: " КОНОТОЛ "
  КОНСТАНТИНОВКА: " КОНСТАНТИНІВКА "
  КОНСТАНТИНОВСК: " КОСТЯНТИНІВСЬКА "
  КОНЫШЕВКА: " КОНИШЕВКА "
  КОПЕЙСК-ЧЕЛЯБ.: " Копейська-ЧЕЛЯБ. "
  КОПОРЬЕ: " Копор&#39;є "
  КОПЫЛЬ: " КОПИЛОВ "
  КОРАБЛИНО: " КОРАБЛІН "
  КОРЕЛИЧИ: " Кирилич "
  КОРЕНЕВО: " Коренева "
  КОРЕНОВСК: " Корєновськ "
  КОРЕЦ: " КОРЕЦЬ "
  КОРКИНО-ТОСНО: " Коркін-ТОСНО "
  КОРКИНО-ЧЕЛЯБ.: " Коркін-ЧЕЛЯБ. "
  КОРМА: " КОРМИ"
  КОРМИЛОВКА: "КОРМІЛОВКА "
  КОРНЕЕВКА: " Корніївка "
  КОРОЛЕВЕЦ: " КОРОЛЕВЕЦ "
  КОРОП: " КОРОП "
  КОРОСТЕНЬ: " КОРОСТЕНЬ "
  КОРОСТЫШЕВ: " КОРОСТИШІВ "
  КОРОЧА: " КОРОЧЕ "
  КОРСАКОВ: " КОРСАК "
  КОРСУНЬ-ШЕВЧЕНК: " КОРСУНЬ-Шевченко "
  КОРТКЕРОС: " КОРТКЕРОС "
  КОРЮКОВКА: " Корюківка "
  КОСИХА: " Косих "
  КОСОВ: " КОСІВ "
  КОСТЕРОВО: " КОСТЕРОВО "
  КОСТОМУКША: " Костомукша "
  КОСТОПОЛЬ: " КОСТОПІЛЬ "
  КОСТРОМА: " КОСТРОМА "
  КОСТЮКОВИЧИ: " Костюковичі "
  КОТАЙСК: " КОТАЙСК "
  КОТЕЛЬВА: " Котельва "
  КОТЕЛЬНИКОВО: " КОТЕЛЬНИКОВА "
  КОТЕЛЬНИЧ: " котельнич "
  КОТЛАС: " Котлас "
  КОТЛЫ: " КОТЛИ "
  КОТОВО-ВОЛГОГР.: " Котова-ВОЛГОГР."
  КОТОВО-ГОРЬКИЙ: "Котова-ГОРЬКИЙ "
  КОТОВСК-КИШИНЕВ: " КОТОВСЬК-КИШИНІВ "
  КОТОВСК-ОДЕССА: " КОТОВСЬК-ОДЕСА "
  КОТОВСК-ТАМБОВ: " КОТОВСЬК-ТАМБОВ "
  КОХТЛА-ЯРВЕ: " Кохтла-Ярве "
  КОЧ-АГАЧ: " коч-Агач "
  КОЧЕНЕВО: " КОЧЕНЕВО "
  КОЧКИ: " Купина "
  КОЧКОРКА: " КОЧКОРКА "
  КОЧКУРОВО: " КОЧКУРОВО "
  КОШ-АГАЧ: " Кош-Агач "
  КОШКИ: " ОДИН "
  КОШКУПЫР: " КОШКУПИР "
  КР.-ГВАРДЕЙСКОЕ: " кр.-Гвардійське "
  КР.ГВАРДЕЙСКОЕ: " КР.ГВАРДЕЙСКОЕ "
  КР.ЛИМАР-ДОНЕЦК: " КР . Лимар-ДОНЕЦЬК "
  КРАМАТОРСК: " КРАМАТОРСЬК "
  КРАСИЛОВ: " КРАСИЛІВ "
  КРАСЛАВА: " Краслави "
  ? "КРАСНАЯ ГОРА"
  : " ЧЕРВОНА ГОРА "
  ? "КРАСНАЯ ГОРБАТК"
  : " ЧЕРВОНА Горбатко "
  КРАСНОАРМЕЙСК: " КРАСНОАРМІЙСЬК "
  ? "КРАСНОАРМЕЙСК С"
  : " КРАСНОАРМІЙСЬК С "
  КРАСНОАРМЕЙСКАЯ: " ЧЕРВОНОАРМІЙСЬКА "
  КРАСНОАРМЕЙСКОЕ: " КРАСНОАРМІЙСЬК"
  КРАСНОБОРСК: "КРАСНОБОРСК "
  КРАСНОВОДСК: " Красноводськ "
  КРАСНОГВАРДЕЙСК: " Красногвардійський "
  КРАСНОГОРОДСКОЕ: " Красноградський "
  КРАСНОГОРСКОЕ: " Красногорський "
  КРАСНОГРАД: " КРАСНОГРАД "
  КРАСНОДАР: " КРАСНОДАР "
  КРАСНОДОН: " КРАСНОДОН "
  КРАСНОЕ: " ЧЕРВОНЕ "
  КРАСНОЕ-НА-ВОЛ: " ЧЕРВОНЕ-НА-ВІЛ "
  КРАСНОЕЛЬСК: " КРАСНОЕЛЬСК "
  КРАСНОЗНАМЕНСК: " Червонопрапорній "
  КРАСНОЗНАМЕНСКО: " Червонопрапорній "
  КРАСНОКАМСК: " Краснокамськ "
  КРАСНОКУТСК: " КРАСНОКУТСЬКИЙ "
  КРАСНООЗЕРСКОЕ: " КРАСНООЗЕРСКОЕ "
  КРАСНОПЕРЕКОПСК: " КРАСНОПЕРЕКОПСЬК "
  КРАСНОПОЛЬЕ: " Краснопілля "
  КРАСНОСЕЛЬСК: " Красносельская "
  КРАСНОСЕЛЬСКОЕ: " Красносельская "
  КРАСНОСЛОБОДСК: " Краснослободськ "
  КРАСНОТУРАНСК: " КРАСНОТУРАНСК "
  КРАСНОТУРЬИНСК: " КРАСНОТУРЬІНСК "
  КРАСНОУРАЛЬСК: " КРАСНОУРАЛЬСК "
  КРАСНОУСОЛЬСКИЙ: " КРАСНОУСОЛЬСКІЙ"
  КРАСНОУФИМСК: "Красноуфімськ "
  КРАСНОЩЕКОВО: " Краснощекова "
  КРАСНОЯРСК: " КРАСНОЯРСЬК "
  ? "КРАСНЫЕ ОКНА"
  : " ЧЕРВОНІ ВІКНА "
  КРАСНЫЙ: " ЧЕРВОНИЙ "
  ? "КРАСНЫЙ БОР"
  : " ЧЕРВОНИЙ БОР "
  ? "КРАСНЫЙ КУТ"
  : " ЧЕРВОНИЙ КУТ "
  ? "КРАСНЫЙ ЛУЧ"
  : " КРАСНИЙ ЛУЧ "
  ? "КРАСНЫЙ СУЛИН"
  : " Червоний Сулін "
  ? "КРАСНЫЙ ЧИКОЙ"
  : " ЧЕРВОНИЙ Чикой "
  ? "КРАСНЫЙ ЯР"
  : " ЧЕРВОНИЙ ЯР "
  КРЕМЕНЕЦ: " КРЕМЕНЕЦЬ "
  КРЕМЕННАЯ: " КРЕМЕНЬ "
  КРЕМЕНЧУГ: " КРЕМЕНЧУК "
  КРЕСТЦЫ: " крижів "
  КРЕТИНГА: " КРЕТІНГА "
  ? "КРИВОЕ ОЗЕРО"
  : " Кривий ОЗЕРО "
  ? "КРИВОЙ РОГ"
  : " КРИВИЙ РІГ "
  КРИНИЧКИ: " КРИНИЧКИ "
  КРИУЛЯНЫ: " КРІУЛЯНИ "
  КРИЧЕВ: " КРИЧИТЬ "
  КРОМЫ: " КРІМ "
  КРОПОТКИН: " Кропоткін "
  КРУГЛОЕ: " КРУГЛІ "
  КРУПКИ: " КРУПКО"
  КРУТИНКА: "КРУТІНКА "
  КРУТИХА: " КРУТІХА "
  КРЫЖОПОЛЬ: " Крижопіль "
  КРЫЛОВСКАЯ: " Криловська "
  КРЫМСК: " КРИМСЬКИХ "
  КСТОВО: " Кстово "
  КУБА: " КУБА "
  КУВА: " кував "
  КУВАНДЫК: " кувандик "
  КУВАСАЙ: " Кувасай "
  КУВШИНОВО: " Кувшиново "
  КУГАЛЫ: " КУГАЛИ "
  КУГЕСИ: " КУГЕСІ "
  КУДЫМКАР: " Кудимкар "
  КУЕДА: " куеда "
  КУЖЕНЕР: " КУЖЕНЕР "
  КУЗЕМКИНО: " КУЗЕМКІНО "
  КУЗНЕЦК: " КУЗНЕЦЬКИЙ "
  КУЗНЕЦОВСК: " КУЗНЄЦОВСЬК "
  КУЗОВАТОВО: " Кузоватово "
  КУЙБ844ЯЯ: " КУЙБ844ЯЯ "
  КУЙБЫШЕВ: " Куйбишев "
  КУЙБЫШЕВ-КАЗАНЬ: " Куйбишев-КАЗАНЬ "
  КУЙБЫШЕВ-НОВОСБ: " Куйбишев - НОВОСБ "
  КУЙБЫШЕВО: " КУЙБИШЕВА"
  КУЙБЫШЕВСК: "КУЙБИШЕВСЬКИЙ "
  КУЙБЫШЕВСКИЙ: " КУЙБИШЕВСЬКИЙ "
  КУЙВОЗИ: " КУЙВОЗІ "
  КУЙГАНЯР: " КУЙГАНЯР "
  КУЛДИГА: " Кулдига "
  КУЛЕБАКИ: " КУЛЕБАКІ "
  КУЛИКОВКА: " Куликівка "
  КУЛУНДА: " Кулунди "
  КУЛЯБ: " Куляба "
  КУМЕНЫ: " КУМЕНИ "
  КУМЕРТАУ: " Кумертау "
  КУМКУРГАН: " КУМКУРГАН "
  КУМЫЛЖЕНСКАЯ: " КУМИЛЖЕНСКАЯ "
  КУНАШАК: " КУНАШАК "
  КУНГРАД: " Кунград "
  КУНГУР: " Кунгур "
  КУНЬЯ: " Кунья "
  КУНЯ-УРГЕНЧ: " Куня-Ургенч "
  КУПИНО: " Купина "
  КУПИШКИС: " КУПІШКІС "
  КУПЯНСК: " КУП&#39;ЯНСЬК "
  КУРАГИНО: " Курагин "
  КУРАХОВО: " КУРАХОВЕ "
  КУРГАЛЬДЖИНСКИЙ: " КУРГАЛЬДЖІНСКІЙ "
  КУРГАН: " КУРГАН"
  КУРГАН-ТЮБЕ: "Курган-Тюбе "
  КУРГАНИНСК: " Курганінського "
  КУРГАНТЕПА: " КУРГАНТЕПА "
  КУРЕСААРЕ: " КУРЕСААРЕ "
  КУРКИНО: " Куркіна "
  КУРСАВКА: " КУРСАВКА "
  КУРСК: " курськ "
  КУРТАМЫШ: " Куртамиш "
  КУРУМКАН: " Курумкан "
  КУРЧАТОВ: " Курчатов "
  КУРЧУМ: " КУРЧУМ "
  КУРЫМКАР: " КУРИМКАР "
  КУРЬЯ: " Кур&#39;я "
  КУСА: " КУНСАН "
  КУСАРЫ: " КУСАРИ "
  КУСИНО: " КУСІНО "
  КУСТАНАЙ: " Кустанай "
  КУТАИСИ: " Кутаїсі "
  КУТУЗОВ: " Кутузов "
  КУШВА: " Кушва "
  КУШНАРЕНКОВО: " КУШНАРЕНКОВО "
  КУЩЕВСКАЯ: " Кущевская "
  КШЕНСКИЙ: " КШЕНСКІЙ "
  КЫЗЫЛ: " Кизил "
  КЫЗЫЛ-КИЯ: " Кизил-кия"
  КЫЗЫЛТЕПА: "КИЗИЛТЕПА "
  КЫТМАНОВО: " КИТМАНОВО "
  КЫШТОВКА: " КИШТОВКА "
  КЫШТЫМ: " Коштом "
  КЯРДЛА: " Кярдла "
  КЯХТА: " Кяхта "
  ЛАБИНСК: " ЛАБІНСЬКИЙ "
  ЛАГОДЕХИ: " ЛАГОДЕХІ "
  ЛАДУШКИН: " ЛАДУШКІН "
  ЛАДЫЖИН: " Ладижин "
  ЛАЗАРЕВСКОЕ: " Лазаревське "
  ЛАЗДИЯЙ: " ЛАЗДІЯЙ "
  ЛАЗО: " ЛАЗО "
  ЛАЗОВСК: " ЛАЗівські "
  ЛАИШЕВО: " Лаїша "
  ЛАНОВЦЫ: " Ланівці "
  ЛАНШ: " ЛАНШ "
  ЛАХДЕНПОХЬЯ: " ЛАХДЕНПОХЬЯ "
  ЛЕБЕДИН: " ЛЕБЕДИН "
  ЛЕБЕДИНОВКА: " ЛЕБЕДІНОВКА "
  ЛЕБЕДЯНЬ: " Лебедянь "
  ЛЕБЯЖЬЕ-КИРОВ: " лебяжа-КІРОВ "
  ЛЕБЯЖЬЕ-КУРГАН: " лебяжа-КУРГАН "
  ЛЕБЯЖЬЕ-ЛОМОНОС: " лебяжа-ЛОМОНОСОВ "
  ЛЕБЯЖЬЕ-ПАВЛОД.: " лебяжа-ПАВЛОД."
  ? "ЛЕВ ТОЛСТОЙ"
  : "ЛЕВ ТОЛСТОЙ "
  ЛЕЖНЕВО: " ЛЕЖНЕВО "
  ЛЕЛЬЧИЦЫ: " Лельчиці "
  ЛЕНГЕР: " Ленгера "
  ЛЕНИНАБАД: " ЛЕНІНАБАД "
  ЛЕНИНАКАН: " Ленинакан "
  ЛЕНИНГРАД: " Ленінград "
  ЛЕНИНГРАДСКАЯ: " ЛЕНІНГРАДСЬКА "
  ЛЕНИНГРАДСКИЙ: " ЛЕНІНГРАДСЬКА "
  ЛЕНИНОГОРСК: " Леніногорськ "
  ЛЕНИНОПОЛЬ: " ЛЕНІНОПОЛЬ "
  ЛЕНИНСК-АНДИЖАН: " Ленінський-Андижан "
  ЛЕНИНСК-ВОЛГОГР: " Ленінський-ВОЛГОГР "
  ЛЕНИНСК-КЗ-ОРДА: " Ленінський-КЗ-ОРДА "
  ЛЕНИНСК-КУЗНЕЦК: " Ленінськ-Кузнецький "
  ЛЕНИНСК-ТАШАУЗ: " Ленінський-ТАШАУЗ "
  ЛЕНИНСКИЙ-ДУШАН: " ЛЕНІНСЬКИЙ-душа "
  ЛЕНИНСКИЙ-КОКЧТ: " ЛЕНІНСЬКИЙ -КОКЧТ "
  ЛЕНИНСКИЙ-ТУЛА: " ЛЕНІНСЬКИЙ-ТУЛА "
  ЛЕНИНСКОЕ-КУСТ.: " Ленінський-кущ. "
  ЛЕНИНСКОЕ-ХАБАР: " Ленінський-ХАБАР "
  ЛЕНКОРАНЬ: " Ленкорань "
  ЛЕНСК: " ЛЕНСЬКИЙ "
  ЛЕОВО: " Леова "
  ЛЕПЕЛЬ: " Лепель"
  ЛЕПСАРЫ: "ЛЕПСАРИ "
  ЛЕПСЫ: " Лепсе "
  ЛЕРМОНТОВ: " ЛЕРМОНТОВ "
  ЛЕСНОЕ: " ЛІСОВЕ "
  ЛЕСНОС: " ЛЕСНОС "
  ЛЕСОГОРСКИЙ: " ЛЕСОГОРСКІЙ "
  ЛЕСОЗАВОД: " лісозавод "
  ЛЕСОЗАВОДСК: " Лесозаводськ "
  ЛЕСОКОМБИНАТ: " ЛІСОКОМБІНАТ "
  ЛЕСОСИБИРСК: " ЛЕСОСІБІРСК "
  ЛЕТИЧЕВ: " Летичів "
  ЛИВНЫ: " ЛІВНІ "
  ЛИВОЗЕРОВО: " ЛІВОЗЕРОВО "
  ЛИДА: " ЛІДА "
  ЛИЕПАЯ: " ЛІЄПАЯ "
  ЛИМАН: " ЛИМАН "
  ЛИМБАЖИ: " Лімбажі "
  ЛИОЗНО: " ліозно "
  ЛИПЕЦК: " ЛИПЕЦЬКА "
  ? "ЛИПИН БОР"
  : " Ліпін Бор "
  ? "ЛИПКАЯ ГОРКА"
  : " ЛИПКАХ ГІРКА "
  ЛИПКИ: " ЛИПКИ "
  ? "ЛИПОВАЯ ДОЛИНА"
  : " ЛИПОВА ДОЛИНА "
  ЛИПОВЕЦ: " ЛИПОВЕЦЬ "
  ЛИСАКОВСК: " Лисаковский"
  ЛИСИНО-КОРПУС: "Лісін-КОРПУС "
  ЛИСИЧАНСК: " ЛІСІЧАНСЬК "
  ЛИТИН: " Літин "
  ЛИХОСЛАВЛЬ: " Лихославль "
  ЛОГОЙСК: " Логойськ "
  ? "ЛОДЕЙНОЕ ПОЛЕ"
  : " лодейне поле "
  ЛОЕВ: " Лоєв "
  ЛОЗОВАЯ: " ЛОЗОВА "
  ЛОКАЧИ: " Локачі "
  ЛОКНЯ: " Локня "
  ЛОКОТЬ: " Локоть "
  ЛОМОНОСОВ: " ЛОМОНОСОВ "
  ЛОПАТИНО: " ЛОПАТІН "
  ЛОПУХИНКА: " ЛОПУХІНКА "
  ЛОТОШИНО: " ЛОТОШІНО "
  ? "ЛОУХИ КАЛЕВАЛА"
  : " лоухи Калевала "
  ЛОХВИЦА: " ЛОХВИЦЯ "
  ЛУБНЫ: " ЛУБНИ "
  ЛУГА: " ЛУГА "
  ЛУГАНСК: " ЛУГАНСЬК "
  ЛУГИНЫ: " ЛУГИНИ "
  ЛУГОВОЕ: " ЛУГОВИЙ "
  ЛУДЗА: " Лудза "
  ЛУНИНЕЦ: " лунінець "
  ЛУНИНО: " ЛУНІН"
  ЛУТУГИНО: "ЛУТУГИНЕ "
  ЛУХОВИЦЫ: " Лохвиця "
  ЛУЦК: " ЛУЦЬК "
  ЛУЧЕГОРСК: " лучегорськ "
  ЛЫСКОВО: " Лисково "
  ? "ЛЫСЫЕ ГОРЫ"
  : " лисі ГОРИ "
  ЛЫСЬВА: " Лисьва "
  ЛЫСЯНКА: " Лисянка "
  ЛЬВОВ: " ЛЬВІВ "
  ЛЬГОВ: " Льгов "
  ЛЮБАНЬ-МИНСК: " Любань-МІНСЬК "
  ЛЮБАНЬ-ТОСНО: " Любань-ТОСНО "
  ЛЮБАР: " ЛЮБАР "
  ЛЮБАШЕВКА: " Любашівка "
  ЛЮБЕШОВ: " Любешів "
  ЛЮБИНСКИЙ: " Любінська "
  ЛЮБОМЛЬ: " ЛЮБОМЛЬ "
  ЛЮБЫТИНО: " ЛЮБИТІНО "
  ЛЮДИНОВО: " ЛЮДІНОВО "
  ЛЯМБИРЬ: " ЛЯМБІРЬ "
  ЛЯХОВИЧИ: " ЛЯХОВИЧ "
  МАГАДАН: " Магадан "
  МАГАН: " МАГА "
  МАГДАГАЧИ: " магдагачі "
  МАГДАЛИНОВКА: " Магдалинівка"
  МАГНИТОГОРСК: "МАГНІТОГОРСЬКА "
  МАДОНА: " МАДОННА "
  МАЖЕЙКЯЙ: " Мажейкяй "
  МАЙКАИН: " МАЙКАІН "
  МАЙКОП: " Майкоп "
  МАЙЛИСАЙ: " МАЙЛІСАЙ "
  МАЙМА: " Майми "
  МАЙНА: " МАЙНА "
  МАЙСКОЕ: " ТРАВНЕВІ "
  МАЙЯ: " МАЙЯ "
  МАКАНЧИ: " МАКАНЧІ "
  МАКАРОВ: " МАКАРОВ "
  МАКАРЬЕВ: " Макаров "
  МАКЕЕВКА: " МАКІЇВКА "
  МАКИНСК: " МАКІНСК "
  МАКСАТИХА: " Максатиха "
  МАКСИМОВКА: " Максимівка "
  МАКУШИНО: " Макушин "
  ? "МАЛАЯ ВИШЕРА"
  : " Мала Вішера "
  ? "МАЛАЯ ПУРГА"
  : " МАЛА ЗАМЕТІЛЬ "
  ? "МАЛАЯ СЕРДОБА"
  : " МАЛА Сердобов "
  МАЛГОБЕК: " Малгобек "
  МАЛИН: " МАЛІН "
  МАЛМЫЖ: " МАЛМИЖ "
  МАЛОАРХАНГЕЛЬСК: " Малоархангельськ"
  МАЛОРИТА: "Малорита "
  МАЛОЯРОСЛАВЕЦ: " Малоярославець "
  МАМАДЫШ: " МАМАДИШ "
  МАМЛЮТКА: " МАМЛЮТКА "
  МАМОНОВО: " Мамонова "
  МАМОНТОВО: " Мамонтова "
  МАНГИТ: " Манга "
  МАНЕВИЧИ: " МАНЕВИЧА "
  МАНТУРОВО: " МАНТУРОВО "
  МАНЬКОВКА: " Маньківка "
  МАРАЛИК: " МАРАЛІК "
  МАРГАНЕЦ: " МАРГАНЕЦЬ "
  МАРГИЛАН: " МАРГІЛАН "
  МАРГУШИ: " МАРГУШІ "
  МАРИ-ТУРЕК: " МАРИ-Турек "
  МАРИИНСК: " Маріїнськ "
  ? "МАРИЙСКИЙ ПОСАД"
  : " МАРІЙСЬКА ПОСАД "
  МАРИНОВКА: " Маринівка "
  МАРИУПОЛЬ: " МАРІУПОЛЬ "
  МАРИЯМПОЛЕ: " Маріямполе "
  МАРКОВКА: " Марківка "
  МАРКС: " МАРКС "
  МАРНЕУЛИ: " Марнеулі "
  МАРТУК: " МАРТУК "
  МАРТУНИ: " МАРТУНІ"
  МАРХАМАТ: "МАРХАМАТ "
  МАРЫ: " Мари "
  ? "МАРЬИНА ГОРКА"
  : " Мар&#39;їна Горка "
  МАРЬИНКА: " Мар&#39;їнка "
  МАРЬЯНОВКА: " Мар&#39;янівка "
  МАСИС: " Масіс "
  МАСЛЯНИНО: " МИСЛЕННЯ "
  МАССАЛЫ: " Массалов "
  ? "МАТВЕЕВ КУРГАН"
  : " МАТВЄЄВ КУРГАН "
  МАХАЧКАЛА: " Махачкала "
  МАШЕВКА: " Машівка "
  МГЛИН: " Мглин "
  МЕДВЕЖЬЕГОРСК: " Медвеж&#39;єгорська "
  МЕДВЕНКА: " МЕДВЕНКА "
  МЕДНОГОРСК: " мідногорськ "
  МЕДЫНЬ: " Мединя "
  МЕЖГОРЬЕ: " МІЖГІР&#39;Я "
  МЕЖДУРЕЧЕНСК: " Мєждурєченськ "
  МЕЖЕВАЯ: " Межова "
  МЕЛЕНКИ: " Меленко "
  МЕЛЕУЗ: " Мелеуз "
  МЕЛИТОПОЛЬ: " МЕЛІТОПОЛЬ "
  МЕЛОВОЕ: " Мілове "
  МЕЛЬНИК-ПРИОЗЕР: " МЕЛЬНИК - Приозер&#39;я "
  ? "МЕЛЬНИКОВО ТОМ"
  : " МЕЛЬНИКОВА ТОМ"
  МЕНА: "МЕНА "
  МЕНДЕЛЕЕВСК: " менделєєвськая "
  МЕНЗЕЛИНСК: " МЕНЗЕЛІНСК "
  МЕРКЕ: " Мерк "
  МЕРНОГОРСК: " МЕРНОГОРСК "
  МЕСЯГУТОВО: " МЕСЯГУТОВО "
  МЕЩОВСК: " МЕЩОВСК "
  МИАСКОЕ: " МІАСКОЕ "
  МИАСС-УРАЛАВТОЗ: " МИАСС-УРАЛАВТОЗ "
  МИАСС-ЧЕЛЯБИНСК: " МИАСС-ЧЕЛЯБІНСЬК "
  МИАССКОЕ: " МІАССКОЕ "
  МИГИРИН: " МІГІРІН "
  МИЛЛЕРОВО: " Міллерово "
  МИЛЬКОВО: " Милькова "
  МИЛЮТИНСКАЯ: " Милютинський "
  МИНВОДЫ: " Мінводи "
  МИНГЕЧАУР: " Мінгечаур "
  МИНСК: " МІНСЬК "
  МИНУСИНСК: " Мінусинськ "
  МИОРЫ: " Міорі "
  МИРГОРОД: " МИРГОРОД "
  МИРНЫЙ: " МИРНИЙ "
  МИРОНОВКА: " миронівка "
  МИХАЙЛОВ: " МИХАЙЛОВ "
  МИХАЙЛОВКА: " Михайлівка"
  МИЧУРИНСК: "Мічурінськ "
  МИШКИНО: " Мишкина "
  МЛИНОВ: " МЛИН "
  МОГИЛЕВ: " МОГИЛІВ "
  ? "МОГИЛЕВСК ПОД"
  : " МОГИЛЕВСЬКА ПІД "
  МОЖАЙСК: " Можайськ "
  МОЖГА: " можга "
  МОЗДОК: " Моздок "
  МОЗЫРЬ: " Мозир "
  МОКРОУС: " МОКРОУСОВ "
  МОКРОУСОВО: " МОКРОУСОВА "
  МОКШАН: " мокшан "
  МОЛЕТАЙ: " МОЛЕТАЙ "
  МОЛОДЕЖНОЕ: " МОЛОДІЖНЕ "
  МОЛОДЕЧНО: " Молодечно "
  МОЛЧАНОВО: " МОЛЧАНОВУ "
  МОНАСТЫРИСКА: " Монастириська "
  МОНАСТЫРИЩЕ: " Монастирище "
  МОНАСТЫРЩИНА: " МОНАСТИРЩІНА "
  МОНЧЕГОРСК: " Мончегорськ "
  МОРГАУШИ: " МОРГАУШІ "
  МОРДОВО: " Мордово "
  МОРКИ: " Морк "
  МОРОЗОВСК: " Морозовськ "
  МОРШАНСК: " Моршанськ"
  МОСАЛЬСК: "Мосальських "
  МОСКАЛЕНКИ: " Москаленко "
  МОСКВА: " МОСКВА "
  МОСКОВСКИЙ: " МОСКОВСЬКИЙ "
  МОСТИСКА: " МОСТИСЬКИЙ "
  МОСТОВСКОЕ: " Мостовський "
  МОСТЫ: " МОСТИ "
  МОШЕНСКОЕ: " Мошенський "
  МОШКОВО: " Мошкова "
  МРАКОВО: " МРАКОВО "
  МСТИСЛАВЛЬ: " Мстиславля "
  МУБАРЕК: " Мубарек "
  МУЕЗЕРСКИЙ: " МУЕЗЕРСКІЙ "
  МУКАЧЕВО: " МУКАЧЕВО "
  МУРМАНСК: " МУРМАНСЬК "
  МУРМАНСК-130: " МУРМАНСЬК-130 "
  ? "МУРОВ КУРИЛОВЦЫ"
  : " Мурів Курилівці "
  МУРОМ: " МУРОМ "
  МУРОМЦЕВО: " Муромцева "
  МУСЛЮМОВО: " МУСЛЮМОВО "
  МУХОРШИБИРЬ: " Мухоршибір "
  МУЧКАПСКИЙ: " Мучкапський "
  МЦЕНСК: " Мценськ "
  МЫСКИ: " миска "
  МЯДЕЛЬ: " МЯДЕЛЬ"
  Н-АКМЯНЕ: "Н-АКМЯНЕ "
  Н-АЛТАЙСК: " Н-Алтайськ "
  Н-ИНГАШ: " Н-ІНГАШ "
  Н-НИКОЛАЕВКА: " Н-Миколаївка "
  Н-ШУЛЬБА: " Н-ШУЛЬБА "
  ? "НАБЕРЕЖ ЧЕЛНЫ"
  : " НАБЕРЕЖ Челни "
  НАВАШИНО: " Навашина "
  НАВЛЯ: " Навля "
  НАВОИ: " НАВОЇ "
  НАДВОРНАЯ: " Надвірна "
  НАДТЕРЕЧНАЯ: " НАДТЕРЕЧНАЯ "
  НАДЫМ: " Надим "
  НАЗАРОВО: " НАЗАРОВА "
  НАЗРАНЬ: " НАЗРАНЬ "
  НАЗЫВАЕВСК: " НАЗИВАЕВСК "
  НАЛЬЧИК: " Нальчик "
  НАМАНГАН: " Наманган "
  НАМЦЫ: " НАМЦИ "
  НАРВА: " Нарва "
  НАРИМАНОВ: " Наріманов "
  НАРИМАНОВКА: " НАРІМАНОВКА "
  НАРИМАНОВО: " Нариманова "
  НАРО-ФОМИНСК: " Наро-Фомінськ "
  НАРОВЛЯ: " Наровля "
  НАРОВЧАТ: " Наровчат"
  НАРОДИЧИ: "Народичі "
  НАРОЧЬ: " Нароч "
  НАРТКАЛА: " НАРТКАЛА "
  НАРЫН: " Нарин "
  НАРЫНКА: " НАРИНКА "
  НАРЫШКИНО: " Наришкін "
  НАУРСКИЙ: " Наурська "
  НАФТАЛАН: " НАФТАЛАН "
  НАХИЧЕВАНЬ: " Нахічевань "
  НАХОДКА: " ЗНАХІДКА "
  НАЧАЛОВО: " Началова "
  НЕБИТ-ДАГ: " Небит-Даг "
  НЕВЕЛЬ: " Невель "
  НЕВЕЛЬСК: " Невельськ "
  НЕВЕРКИНО: " НЕВЕРКІНО "
  НЕВИННОМЫССК: " Невинномиськ "
  НЕВЬЯНСК: " Невьянськ "
  НЕДРИГАЙЛОВО: " Недригайлові "
  НЕЖИН: " НІЖИН "
  НЕКРАСОВСКОЕ: " Некрасовська "
  НЕЛИДОВО: " Нелідово "
  НЕМА: " НЕМА "
  НЕМАН: " НЕМАН "
  НЕМИРОВ: " НЕМИРІВ "
  НЕРЕХТА: " Нерехта"
  НЕРЧИНСК: "Нерчинськ "
  НЕРЮНГРИ: " Нерюнгрі "
  НЕСВИЖ: " Несвіж "
  НЕСТЕРОВ: " НЕСТЕРОВ "
  НЕФТЕГОРСК: " Нєфтєгорський "
  НЕФТЕКАМСК: " Нефтекамськ "
  НЕФТЕКУМСК: " НЕФТЕКУМСК "
  НЕФТЕЧАЛА: " НЕФТЕЧАЛА "
  НЕФТЕЮГАНСК: " Нафтоюганська "
  НЕХАЕВСКИЙ: " НЕХАЕВСКІЙ "
  НИБРАЙ: " НІБРАЙ "
  НИДА: " НІДА "
  ? "НИЖНАЯ ОМКА"
  : " Нижній ОМКА "
  НИЖНЕВАРТОВСК: " Нижньовартовськ "
  НИЖНЕГОРСКИЙ: " НИЖНЬОГОРСЬКИЙ "
  НИЖНЕДЕВИЦК: " нижнєдівицьк "
  НИЖНЕКАМСК: " Нижньокамськ "
  ? "НИЖНИЕ СЕРЕГОЗЫ"
  : " Нижній СЕРЕГОЗИ "
  ? "НИЖНИЙ ЛОМОВ"
  : " НИЖНІЙ Ломов "
  ? "НИЖНИЙ СЕРГИ"
  : " НИЖНІЙ Серго "
  ? "НИЖНИЙ ТАГИЛ"
  : " НИЖНІЙ ТАГИЛ "
  ? "НИЖНИЙ ТУРА"
  : " НИЖНІЙ ТУРУ "
  ? "НИЖНЯЯ ТАВДА"
  : " Нижня Тавда "
  НИЗИНО: " Низин "
  НИКИТИНКА: " НІКІТІНКА"
  НИКОЛАЕВ: "МИКОЛАЇВ "
  НИКОЛАЕВ-ЛЬВОВ: " МИКОЛАЇВ-ЛЬВІВ "
  НИКОЛАЕВКА: " Миколаївка "
  НИКОЛАЕВСК: " Миколаївська "
  НИКОЛАЕВСК-АМУР: " Миколаївська-АМУР "
  НИКОЛАЕВЩИНА: " МИКОЛАЇВЩИНА "
  НИКОЛЬСК-ВОЛОГД: " Нікольськ-Вологда "
  НИКОЛЬСК-ПЕНЗА: " Нікольськ-Пенза "
  НИКОЛЬСКИЙ: " МИКІЛЬСЬКИЙ "
  НИКОЛЬСКОЕ: " МИКІЛЬСЬКИЙ "
  НИКОПОЛЬ: " НІКОПОЛЬ "
  НИСПОРЕНЫ: " НІСПОРЕНИ "
  НОВАННИНСКИЙ: " НОВАННІНСКІЙ "
  ? "НОВАЯ ВОДОЛАГА"
  : " НОВА ВОДОЛАГА "
  ? "НОВАЯ КАХОВКА"
  : " НОВА КАХОВКА "
  ? "НОВАЯ ЛАДОГА"
  : " Нова Ладога "
  ? "НОВАЯ МАЛЫКЛА"
  : " НОВА МАЛИКЛА "
  ? "НОВАЯ ОДЕССА"
  : " НОВА ОДЕСА "
  ? "НОВАЯ УСМАНЬ"
  : " НОВА Усмані "
  ? "НОВАЯ УШИЦА"
  : " НОВА УШИЦЯ "
  НОВГОРОД: " НОВГОРОД "
  НОВГОРОД-СЕВЕРС: " НОВГОРОД-СЕВЕРС "
  НОВГОРОДКА: " НОВГОРОДКА "
  НОВГОРОДСКОЕ: " НОВГОРОДСЬКА "
  НОВИНКА: " НОВИНКА"
  НОВИЧИХА: "НОВІЧІХА "
  НОВО-АЛЕКСАНДР: " НОВО-ОЛЕКСАНДР "
  НОВО-ВОРОНЕЖСК: " НОВО-Воронезькій "
  НОВОАЗОВСК: " НОВОАЗОВСЬКИЙ "
  НОВОАЙДАР: " Новоайдар "
  НОВОАЛЕКСАНДРОВ: " НОВОАЛЕКСАНДРОВ "
  НОВОАЛЕКСЕЕВКА: " новоолексіївка "
  НОВОАЛТАЙСК: " Новоалтайськ "
  НОВОАРХАНГЕЛЬСК: " НОВОАРХАНГЕЛЬСЬКИЙ "
  НОВОБИРИЛЮССЫ: " НОВОБІРІЛЮССИ "
  НОВОВАРШАВКА: " НОВОВАРШАВКА "
  НОВОВОЛЫНСК: " НОВОВОЛИНСЬК "
  НОВОВОРОНЦОВКА: " НОВОВОРОНЦОВКА "
  НОВОВЯТСК-КИРОВ: " НОВОВЯТСК-КІРОВ "
  НОВОГРАД-ВОЛЫНС: " НОВОГРАД-ВОЛИНС "
  НОВОГРУДОК: " Новгородка "
  НОВОДУГИНО: " НОВОДУГІНО "
  НОВОЕГОРЬЕВСКОЕ: " НОВОЕГОРЬЕВСКОЕ "
  НОВОЗЫБКОВ: " Новозибков "
  НОВОКИЕВ-УВАЛ: " Новоком-Увал "
  НОВОКУБАНСК: " Новокубанськ "
  НОВОКУЗНЕЦК: " НОВОКУЗНЕЦЬК "
  НОВОКУЙБЫШЕВСК: " Новокуйбишевськ "
  НОВОЛИСИНО: " НОВОЛІСІНО "
  НОВОМИРГОРОД: " НОВОМИРГОРОД"
  НОВОМОСКОВСК: "НОВОМОСКОВСЬК "
  НОВОНИКОЛАЕВКА: " Новомиколаївка "
  НОВОНИКОЛАЕВСКИ: " НОВОМИКОЛАЇВСЬКИЙ "
  НОВОПАВЛОВСК: " Новопавлівська "
  НОВОПОКРОВКА: " Новопокровка "
  НОВОПОКРОВСКАЯ: " Новопокровський "
  НОВОПОЛОЦК: " Новополоцьк "
  НОВОПСКОВ: " НОВОПСКОВ "
  НОВОРЖЕВ: " НОВОРЖЕВ "
  НОВОРОССИЙСК: " НОВОРОСІЙСЬК "
  НОВОСЕЛИЦА: " НОВОСЕЛИЦЯ "
  НОВОСЕЛИЦКОЕ: " НОВОСЕЛИЦЬКИЙ "
  НОВОСЕЛОВО: " Новоселова "
  НОВОСЕРГИЕВКА: " НОВОСЕРГІЕВКА "
  НОВОСИБИРСК: " НОВОСИБІРСЬК "
  НОВОСИЛЬ: " НОВОСІЛЬ "
  НОВОСОКОЛЬНИКИ: " новосокольники "
  НОВОСПАССКОЕ: " Новоспаське "
  НОВОТРОИЦК: " НОВОТРОЇЦЬКИЙ "
  НОВОТРОИЦКОЕ: " НОВОТРОЇЦЬКИЙ "
  НОВОУЗЕНСК: " Новоузенськ "
  НОВОУКРАИНКА: " Новоукраїнка "
  НОВОХОПЕРСК: " Новохоперського "
  НОВОЧЕРКАССК: " Новочеркаськ "
  НОВОШАХТИНСК: " Новошахтинськ"
  НОВОЯКЕНТ: "НОВОЯКЕНТ "
  ? "НОВЫЕ АНЕНЫ"
  : " НОВІ АНЕНИ "
  ? "НОВЫЕ БУРАСЫ"
  : " НОВІ БУРАС "
  ? "НОВЫЕ САНЖАРЫ"
  : " Нові Санжари "
  ? "НОВЫЙ БУЧ"
  : " НОВИЙ Буч "
  ? "НОВЫЙ ОСКОЛ"
  : " Новий Оскол "
  ? "НОВЫЙ РАЗДОЛ"
  : " Новий Розділ "
  ? "НОВЫЙ ТОРЬЯЛ"
  : " НОВИЙ ТОРЬЯЛ "
  ? "НОВЫЙ УРЕНГОЙ"
  : " НОВИЙ УРЕНГОЙ "
  НОГИНСК: " Ногинск "
  НОГЛИКИ: " Ноглики "
  НОЕМБЕРЯН: " НОЕМБЕРЯН "
  НОЖАЙ-ЮРТ: " Ножай-ЮРТ "
  НОЛИНСК: " Нолинському "
  НОСОВКА: " Носівка "
  НОЯБРЬСК: " Небраска "
  НУКУС: " Нукус "
  НУРАТА: " НУРАТА "
  НУРЕК3: " НУРЕК3 "
  НУРЛАТ: " НУРЛАТ "
  НУРМА: " Нурмі "
  НЫТВА: " НИТВА "
  НЮКСЕНИЦА: " Нюксениця "
  НЮРБА: " НЮРБА "
  НЯЗЕПЕТРОВСК: " НЯЗЕПЕТРОВСК"
  НЯНДОМА: "Няндома "
  ОБИКИИК: " ОБІКІІК "
  ОБЛУЧЬЕ: " облуччя "
  ОБНИНСК: " ОБНИНСК "
  ОБОЯНЬ: " Обоянь "
  ОБУХОВ: " ОБУХІВ "
  ОБЬЯЧЕВО: " ОБЬЯЧЕВО "
  ОВИДИОПОЛЬ: " Овідіополь "
  ОВРУЧ: " ОВРУЧ "
  ОГРЕ: " ОГРЕ "
  ОДЕССА: " ОДЕСА "
  ОДЕССКОЕ: " ОДЕСЬКЕ "
  ОДОЕВ: " ОДОЕВ "
  ОЗЕРСК: " Озерськ "
  ОЗЕРЫ: " озера "
  ОЗИНКИ: " ОЗНАКИ "
  ОКНИЦА: " ОКНИЦЯ "
  ОКОНЕШНИКОВО: " ОКОНЕШНІКОВО "
  ОКТЕМБЕРЯН: " ОКТЕМБЕРЯН "
  ОКТЯБР-ВОЛГОГР: " Жовтень-ВОЛГОГР "
  ОКТЯБРЬСК-АКТЮБ: " Октябрьская-Актюбе "
  ОКТЯБРЬСК-ГОМ: " Октябрьская-ГОМ "
  ОКТЯБРЬСК-КУЙБ: " Октябрьская-КУЙБ "
  ОКТЯБРЬСК-ПЕРМЬ: " Октябрьская-ПЕРМ "
  ОКТЯБРЬСК-ТАШАУ: " Октябрьская-Таша"
  ОКТЯБРЬСКИЙ: "ЖОВТНЕВА "
  ОКТЯБРЬСКОЕ-ОРД: " ОКТЯБРЬСКОЕ-ОРД "
  ОКТЯБРЬСКОЕ-ТЮМ: " ОКТЯБРЬСКОЕ-ТЮМ "
  ОКТЯБРЬСКОЕ-ЧЕЛ: " ОКТЯБРЬСКОЕ-ЧЕЛ "
  ОКУЛОВКА: " Окуловка "
  ОЛЕВСК: " ОЛЕВСЬКИЙ "
  ОЛЕКМИНСК: " Олекмінськ "
  ОЛЕНЕГОРСК: " Оленєгорськ "
  ОЛЕНИНО: " Оленіна "
  ОЛЕНОВКА: " Оленівка "
  ОЛОНЕЦ: " Олонець "
  ОЛЬГА: " ОЛЬГА "
  ОЛЬХОВАТКА: " Вільхуватка "
  ОЛЬХОВКА: " Вільхівці "
  ОЛЬШАНКА: " Вільшанка "
  ОМСК: " Омськ "
  ОМСУКЧАН: " ОМСУКЧАН "
  ОМУТИНСКИЙ: " ОМУТІНСКІЙ "
  ОМУТНИНСК: " ОМУТНІНСК "
  ОНГУДАЙ: " Онгудай "
  ОНЕГА: " Онега "
  ОНУФРИЕВКА: " Онуфріївка "
  ОПОЧКА: " Опочка "
  ОРАТОВ: " Оратів "
  ОРГЕЕВ: " Оргеев"
  ОРДА: "ОРДА "
  ОРДЖОНИКИДЗЕ: " ОРДЖОНІКІДЗЕ "
  ОРДЖОНИКИДЗЕВСК: " Орджонікідзевський "
  ОРДЫНСК: " Ординський "
  ОРЕЛ: " ОРЕЛ "
  ОРЕНБУРГ: " ОРЕНБУРГ "
  ОРЕХОВ: " ОРЄХОВ "
  ОРЕХОВО-ЗУЕВО: " Орєхово-Зуєва "
  ОРЖИЦА: " ОРЖИЦЯ "
  ОРИЧИ: " Оріч "
  ОРЛОВСКИЙ: " ОРЛОВСЬК "
  ОРОТУКАН: " Оротукан "
  ОРСК: " ОРСК "
  ОРША: " ОРША "
  ОРШАНКА: " ОРШАНКА "
  ОСАКАРОВКА: " осакарівка "
  ОСИННИКИ: " Осічняки "
  ОСИПОВИЧИ: " Йосипович "
  ОССОРА: " ОССОРА "
  ОСТАШКОВО: " Осташкові "
  ОСТРОВ: " ОСТРІВ "
  ОСТРОВЕЦ: " островець "
  ОСТРОВСКОЕ: " ОСТРОВСЬКИЙ "
  ОСТРОГ: " ОСТРОГ "
  ОСТРОГОЖСК: " Острогожськ"
  ОТРАДНАЯ: "Відрадний "
  ОТРАДНОЕ-ВЫБОРГ: " Відрадний-Виборг "
  ОТРАДНОЕ-КИРОВ: " Відрадний-КІРОВ "
  ОТРАДНЫЙ: " Відрадний "
  ОХАНСК: " ОХАНСК "
  ОЧАКОВ: " ОЧАКІВ "
  ОЧЕР: " Очер "
  ОШМЯНЫ: " Ошмяни "
  ПАВИНО: " ПАВІНО "
  ? "ПАВЛОВ ПОСАД"
  : " ПАВЛОВ ПОСАД "
  ПАВЛОВО: " Павлова "
  ПАВЛОВСК-БАРНАУ: " ПАВЛОВСЬКИЙ-БАРНАУ "
  ПАВЛОВСК-ВОРОН: " ПАВЛОВСЬКИЙ-ВОРОН "
  ПАВЛОВСКАЯ: " ПАВЛОВСЬКИЙ "
  ПАВЛОГРАД: " ПАВЛОГРАД "
  ПАВЛОГРАДКА: " ПАВЛОГРАДКА "
  ПАВЛОДАР: " ПАВЛОДАР "
  ПАЙДЕ: " Пайде "
  ПАЙТУГ: " ПАЙТУГ "
  ПАЙШАНБА: " ПАЙШАНБА "
  ПАКРУОЙИС: " ПАКРУОЙІС "
  ПАЛАНА: " Палау "
  ПАЛАНГА: " Паланга "
  ПАЛАТКА: " ПАЛАТКА "
  ПАЛЕХ: " Палех"
  ПАЛКИНО: "ПАЛКІНА "
  ПАЛЛАСОВКА: " Палласовка "
  ПАНЕВЕЖИС: " ПАНЯВЕЖИС "
  ПАНИНО: " ПАНИН "
  ПАНКРУШИХА: " ПАНКРУШІХА "
  ПАНФИЛОВ: " Панфілов "
  ПАРАБЕЛЬ: " Парабель "
  ПАРАНЬГА: " ПАРАНЬГА "
  ПАРКЕНТ: " ПАРКЕНТ "
  ПАРТИЗАНСК: " ПАРТИЗАНСЬКОЇ "
  ПАРТИЗАНСКОЕ: " ПАРТИЗАНСЬКОЇ "
  ПАРФЕНЬЕВО: " ПАРФЕНЬЕВО "
  ПАРФИНО: " Парфіно "
  ПАРХАР: " ПАРХАР "
  ПАСВАЛИС: " ПАСВАЛІС "
  ПАХТААБАД-АНДЖ: " ПАХТААБАД-Анджу "
  ПАХТААБАД-ГУЛ: " ПАХТААБАД-ГУЛ "
  ПАХТАКОР: " Пахтакор "
  ПАЧЕЛМА: " ПАЧЕЛМА "
  ПАША: " ПАША "
  ПАШКАНЫ: " ПАШКАНИ "
  ПЕКЕНТ: " ПЕКЕНТ "
  ПЕКИЛАЕВО: " ПЕКІЛАЕВО "
  ПЕНДЖИКЕНТ: " ПЕНДЖІКЕНТ "
  ПЕНЗА: " Пенза"
  ПЕНО: "ПІНО "
  ПЕРВОМАЙСК: " ПЕРВОМАЙСК "
  ПЕРВОМАЙСКОЕ: " ПЕРВОМАЙСЬКЕ "
  ПЕРВОУРАЛЬСК: " Першоуральському "
  ПЕРЕВАЛЬСК: " ПЕРЕВАЛЬСЬКИЙ "
  ПЕРЕВОЛОЦКИЙ: " переволоцкая "
  ПЕРЕЛЮБ: " Перелюб "
  ПЕРЕМЕТНОЕ: " переметна "
  ПЕРЕМЫШЛЬ: " Перемишль "
  ПЕРЕМЫШЛЯНЫ: " Перемишляни "
  ПЕРЕСЛАВЛЬ-ЗАЛ: " Переславль-ЗАЛ "
  ПЕРЕЧИН: " ПЕРЕЧИН "
  ПЕРЕЯСЛАВКА: " Переяславка "
  ПЕРЕЯСЛАВЛЬ: " Переяславль "
  ПЕРМЬ: " ПЕРМ "
  ПЕРМЬ-76: " ПЕРМ-76 "
  ПЕРОВО: " ПЕРОВА "
  ПЕРШОТРАВИНСК: " ПЕРШОТРАВІНСК "
  ПЕРШОТРАВНЕВОЕ: " ПЕРШОТРАВНЕВИЙ "
  ПЕРШОТРАВНОЕ: " Першотравня "
  ПЕСТОВО: " Пестова "
  ПЕСТРИЦЫ: " ПЕСТРІЦИ "
  ПЕСЧАНКА: " Піщанка "
  ПЕСЧАНОКОПСКОЕ: " ПЕСЧАНОКОПСКОЕ "
  ПЕТИЛИНО: " ПЕТІЛІНО"
  ПЕТРИКОВ: "ПЕТРИК "
  ПЕТРОВО: " ПЕТРОВО "
  ПЕТРОВСК: " ПЕТРОВСЬКА "
  ПЕТРОВСКОЕ: " ПЕТРОВСЬКОГО "
  ПЕТРОЗАВОДСК: " Петрозаводськ "
  ПЕТРОПАВЛОВКА: " Петропавлівка "
  ПЕТРОПАВЛОВСК: " ПЕТРОПАВЛІВСЬКА "
  ПЕТРОПАВЛОВСКОЕ: " ПЕТРОПАВЛІВСЬКА "
  ПЕТУХОВО: " Петухова "
  ПЕТУШКИ: " Півника "
  ПЕЧОРА: " Печора "
  ПЕЧОРЫ: " Печора "
  ПИЛЬНА: " ПІЛЬНИХ "
  ПИНСК: " ПІНСЬК "
  ПИОНЕРСК: " ПІОНЕРСЬКА "
  ПИРОВСКОЕ: " ПІРОВСКОЕ "
  ПИРЯТИН: " ПИРЯТИН "
  ПИТЕРКА: " ПЕТРУК "
  ПИТКЯРАНТА: " ПІТКЯРАНТА "
  ПЛАВСК: " ПЛАВСК "
  ПЛАСТ: " ПЛАСТ "
  ПЛЕШАНОВО: " ПЛЕШАНОВО "
  ПЛУНГЕ: " Плунге "
  ПЛЮССА: " Плюсс "
  ПОБЕДА: " ПЕРЕМОГА"
  ПОВОРИНО: "Поверни "
  ПОГАР: " Погар "
  ПОГРАНИЧНЫЙ: " ПРИКОРДОННИЙ "
  ПОГРЕБИЩЕ: " ПОГРЕБИЩЕ "
  ПОДВОЛОЧИНСК: " Підволочиськ "
  ПОДГОРЕНСКИЙ: " ПОДГОРЕНСКІЙ "
  ПОДДОРЬЕ: " ПОДДОРЬЕ "
  ПОДОЛЬСК: " ПОДОЛЬСК "
  ПОДПОРОЖЬЕ: " подпорожье "
  ПОКРОВ: " ПОКРОВ "
  ПОКРОВКА: " Покровка "
  ПОКРОВСК: " ПОКРОВСЬКИЙ "
  ПОКРОВСКОЕ: " ПОКРОВСКІ "
  ПОЛЕВСКОЙ: " Полівське "
  ПОЛЕССК: " ПОЛІСЬКИЙ "
  ПОЛЕССКОЕ: " ПОЛІСЬКИЙ "
  ПОЛОВИННОЕ: " ПОЛЮВАННЯ "
  ПОЛОГИ: " ПОЛОГИ "
  ПОЛОННОЕ: " ПОЛОННЕ "
  ПОЛОЦК: " ПОЛОЦЬК "
  ПОЛТАВА: " ПОЛТАВА "
  ПОЛТАВКА: " ПОЛТАВКА "
  ПОЛЯРНЫЙ: " ПОЛЯРНЕ "
  ПОМЕРАНЬЕ: " Померанія "
  ПОНАЗЫРЕВО: " ПОНАЗИРЕВО"
  ПОНЫРИ: "Понирі "
  ПОПАСНАЯ: " попасна "
  ПОПЕЛЬНЯ: " Попільня "
  ПОРЕЦКОЕ: " ПРОЦИК "
  ПОРОНАЙСК: " Поронайськ "
  ПОРХОВ: " ПРИХОВУЄ "
  ПОРЫГИНО: " ПОРИГІНО "
  ПОС-ИМ-МОРОЗОВА: " ПОС-ІМ-МОРОЗОВА "
  ПОСЕЛОК-ТЕЛЬМАН: " СЕЛИЩЕ-ТЕЛЬМАНА "
  ПОСПЕЛИХА: " ПОСПЕЛІХА "
  ПОСТАВЫ: " ПОСТАВИВ "
  ПОТАНИНО: " Потанін "
  ПОТИ: " Поті "
  ПОХВИСТНЕВО: " похвистнево "
  ПОЧЕП: " Почеп "
  ПОЧИНКИ: " Лагодження "
  ПОЧИНОК: " ПОЧИНОК "
  ПОША: " пошана "
  ПРАВДИНСК: " правдинських "
  ПРЕЙЛИ: " Прейлі "
  ПРЕНАЙ: " Пренай "
  ПРЕСНОВКА: " ПРЕСНОВКА "
  ПРЖЕВАЛЬСК: " Пржевальськ "
  ПРИАЗОВСКОЕ: " ПРИАЗОВСЬКИЙ "
  ПРИАРГУНСК: " ПРІАРГУНСК"
  ПРИВОЛЖСК: "Приволзько "
  ПРИЛУКИ: " ПРИЛУКИ "
  ПРИМ-АХТАРСК: " ПРИМ-Ахтарськ "
  ПРИМ-ВЫБОРГ: " ПРИМ-Виборг "
  ПРИМ-ЗАПОРОЖЬЕ: " ПРИМ-ЗАПОРІЖЖЯ "
  ПРИОЗЕРСК: " Приозерськ "
  ПРИПЯТЬ: " ПРИП&#39;ЯТЬ "
  ПРИСТЕНЬ: " Пристінні "
  ПРИЮТНОЕ: " ПРІЮТНОЕ "
  ПРОКОПЬЕВСК: " Прокоп&#39;євськ "
  ПРОЛЕТАРСК: " ПРОЛЕТАРСЬКА "
  ПРОМЫШЛЕННОЕ: " ПРОМИСЛОВЕ "
  ПРОХЛАДНЫЙ: " Прохолодний "
  ПРОХОРОВКА: " Прохорівка "
  ПРОЧЕХ: " ПРОЧЕХ "
  ПРУЖАНЫ: " Пружани "
  ПРЯЖА: " ПРЯЖА "
  ПРЯМИЦИНО: " ПРЯМІЦІНО "
  ПСКОВ: " ПСКОВ "
  ПУГАЧЕВ: " ПУГАЧОВ "
  ПУДОЖ: " Пудож "
  ПУДОСТЫ: " ПУДОСТИ "
  ПУСТОМЫТЫ: " Пустомити "
  ПУСТОШКА: " Пустошка "
  ПУТИВЛЬ: " ПУТИВЛЬ"
  ПУТИЛА: "ПУТИЛА "
  ПУТЯТИНО: " Путятін "
  ПУХОВИЧИ: " пуховичі "
  ПУШКИНО: " Пушкіна "
  ПУШКИНСК-ГОРЫ: " ПУШКІНСЬКА-ГОРИ "
  ПУШНОЕ: " Пушной "
  ПЧЕВЖА: " ПЧЕВЖА "
  ПЫЛВА: " Пилва "
  ПЫТАЛОВО: " ПИТАЛОВО "
  ПЫЩУЧ: " ПИЩУЧ "
  ПЯНДЖ: " Пяндж "
  ПЯРНУ: " Пярну "
  ПЯТИГОРСК: " Пятигорськ "
  ПЯТИХВАТКИ: " ПЯТІХВАТКІ "
  РАДВИЛИШКИС: " РАДВІЛІШКІС "
  РАДЕХОВ: " РАДЕХІВ "
  РАДИОНОВО-НЕСВ: " Радіонова-Несвіт "
  РАДИЩЕВО: " Радищева "
  РАДОМЫШЛЬ: " Радомишль "
  РАДОФИННИКОВО: " РАДОФІННІКОВО "
  РАЗДАН: " Раздан "
  РАЗДЕЛЬНАЯ: " РОЗДІЛЬНА "
  РАЗДОЛЬНОЕ: " Роздольне "
  РАЗМЕТЕЛЕВО: " РАЗМЕТЕЛЕВО "
  РАЙЧИХИНСК: " Райчихінськ"
  РАКВЕРЕ: "Раквере "
  РАКИТНОЕ-БЕЛГ: " РОКИТНЕ-белго "
  РАКИТНОЕ-КИЕВ: " РОКИТНЕ-КИЇВ "
  РАКИТНОЕ-РОВНО: " РОКИТНЕ-РІВНЕ "
  РАМЕКШИ: " РАМЕКШІ "
  РАМЕНСКОЕ: " Раменське "
  РАМОНЬ: " РАМОН "
  РАПЛА: " Рапла "
  РАСЕЙНЯЙ: " Расейняй "
  РАССКАЗОВО: " Рассказова "
  РАТНО: " РАТН "
  РАХОВ: " РАХІВ "
  РАХЬЯ: " РАХЬЯ "
  РЕБРИХА: " Ребриха "
  РЕВДА: " ревда "
  РЕЗЕКНЕ: " Резекне "
  РЕЗИНА: " ГУМА "
  РЕМОНТНОЕ: " РЕМОНТНО "
  РЕНИ: " РЕНІ "
  РЕПКИ: " Репка "
  РЕЧИЦА: " Річиця "
  РЕШЕТИЛОВКА: " Решетилівка "
  РЖЕВ: " Ржев "
  РИГА: " РИГА "
  РИШТАН: " РІШТАН"
  РОВЕНЬКИ-БЕЛГ: "РОВЕНЬКИ-белго "
  РОВЕНЬКИ-ВОРОШ: " РОВЕНЬКИ-Во "
  РОВНО: " РІВНЕ "
  РОВНОЕ: " РІВНЕ "
  РОГАТИН: " РОГАТИН "
  РОГАЧОВ: " РОГАЧ "
  РОДИНО: " родина "
  РОДИНСКОЕ: " Родинське "
  РОДИОНОВО-НЕСВ: " РОДІОНОВА-Несвіт "
  РОДНИКИ: " РУДЕНКО "
  РОЖДЕСТВЕННО: " Різдвяний "
  РОЖИЩЕ: " РОЖИЩЕ "
  РОЖНЯТОВ: " Рожнятів "
  РОКИШКИС: " РОКІШКІС "
  РОМАНОВКА: " Романівка "
  РОМАНОВО: " РОМАНОВА "
  РОМАШКИ: " РОМАШКИ "
  РОМИТАН: " РОМІТАН "
  РОМНЫ: " РОМНИ "
  РОМОДАНОВО: " РОМОДАНОВА "
  РОСЛАВЛЬ: " Рославль "
  РОССОНЫ: " РОССОНИ "
  РОССОШЬ: " Россош "
  РОСТОВ: " РОСТОВ "
  РОСТОВ-НА-ДОНУ: " РОСТОВ-НА-ДОНУ"
  РОЩИНО: "РОЩІН "
  РТИЩЕВО: " Ртищево "
  РУБЕЖНОЕ: " РУБІЖНЕ "
  РУБЦОВСК: " Рубцовськ "
  РУДНЫЙ: " РУДНЯ "
  РУДНЯ-ВОЛГОГР: " РУДНЯ-ВОЛГОГР "
  РУДНЯ-СМОЛЕНСК: " РУДНЯ-СМОЛЕНСЬК "
  РУЖИН: " РУЖИН "
  РУЗА: " РУСЕ "
  РУЗАЕВКА-КОКЧЕТ: " Рузаєвка-КОКЧЕТ "
  РУЗАЕВКА-САРАН: " Рузаєвка-Сара "
  РУССКАЯ-ПОЛЯНА: " РУСЬКА-ПОЛЯНА "
  ? "РУССКИЙ КАМЕШКИ"
  : " РОСІЙСКA Камешки "
  РУСТАВИ: " Руставі "
  РЫБЕЖНО: " РИБЕЖНО "
  РЫБИНСК: " Рибінськ "
  ? "РЫБНАЯ СЛОБОДА"
  : " Рибні СЛОБОДА "
  РЫБНИЦА: " Рибниця "
  РЫЛЬСК: " РИЛЬСЬКИЙ "
  РЫШКАНЫ: " РИШКАНИ "
  РЯБОВО-ВЫБОРГ: " РЯБОВ-Виборг "
  РЯБОВО-ТОСНО: " РЯБОВ-ТОСНО "
  РЯЖСК: " Ряжських "
  РЯЗАНЬ: " РЯЗАНЬ "
  С-ПОКРОВКА: " З-Покровка"
  СААТЛЫ: "СААТЛИ "
  САБИРАБАД: " САБІРАБАД "
  САВИНО: " САВИНОВ "
  САВРАНЬ: " САВРАНЬ "
  САКАР: " САКАРА "
  САКИ: " САКИ "
  САКМАРА: " Сакмара "
  САЛАВАТ: " СЛАВУТА "
  САЛДУС: " САЛДУС "
  САЛЕХАРД: " Салехард "
  САЛЬСК: " Сальськ "
  САЛЬЯНЫ: " САЛЬЯНИ "
  САМАРКАНД: " САМАРКАНД "
  САМАРСКОЕ: " САМАРСЬКИЙ "
  САМБОР: " САМБІР "
  САМОЙЛОВКА: " Самойлівка "
  САМТРЕДИА: " Самтредіа "
  САНАТОРИЙ: " САНАТОРІЙ "
  САНДОВО: " САНДОВО "
  САПОЖОК: " чобіток "
  САРАИ: " Сара "
  САРАКТАШ: " саракташ "
  САРАНСК: " томськ "
  САРАНЬ: " Сарань "
  САРАПУЛ: " Сарапул"
  САРАТА: "САРАТА "
  САРАТОВ: " САРАТОВ "
  САРБАДА: " САРБАДА "
  САРГАТСКОЕ: " Саргатське "
  САРКАНД: " Сарканд "
  САРМАНОВО: " САРМАНОВО "
  САРНЫ: " САРНИ "
  САРЫ-ОЗЕК: " САРИ-Озек "
  САРЫАГАН: " САРИАГАН "
  САСОВО: " Сасово "
  САТИНКА: " Сатинка "
  САТКА: " САТКА "
  САФАКУЛЕВО: " САФАКУЛЕВО "
  САФОНОВО: " САФОНОВА "
  САХНОВШИНА: " САХНОВШІНА "
  САЯТ: " Саят "
  СВАЛЯВА: " СВАЛЯВА "
  СВАТОВО: " СВАТОВО "
  СВЕРДЛОВСК: " СВЕРДЛОВСЬК "
  СВЕТЛОВОДСК: " СВІТЛОВОДСЬК "
  СВЕТЛОГОРСК: " Светлогорськ "
  СВЕТЛОГРАД: " СВЕТЛОГРАД "
  СВЕТЛЫЙ: " СВЕТЛЫЙ "
  ? "СВЕТЛЫЙ ЯР"
  : " СВЕТЛЫЙ ЯР "
  СВЕТОГОРСК: " Святогірськ"
  СВИСЛОЧЬ: "Свіслочі "
  СВОБОДНЫЙ: " ВІЛЬНИЙ "
  СДВИНСК: " СДВІНСК "
  СЕБЕЖ: " СЕБЕЖ "
  СЕВАН: " СЕВАН "
  СЕВАСТОПОЛЬ: " СЕВАСТОПОЛЬ "
  СЕВЕРНОЕ: " ПІВНІЧНЕ "
  СЕВЕРОБАЙКАЛЬСК: " Северобайкальск "
  СЕВЕРОДВИНСК: " Северодвінську "
  СЕВЕРОДОНЕЦК: " СІВЕРОДОНЕЦЬК "
  СЕВЕРОМОРСК: " Сєвєроморськ "
  СЕВЕРОУРАЛЬСК: " СЕВЕРОУРАЛЬСК "
  СЕВЕРСК: " СІВЕРСЬКИЙ "
  СЕВЕРСКАЯ: " СІВЕРСЬКИЙ "
  СЕВСК: " Сєвськ "
  СЕГЕЖА: " сегежа "
  СЕЙМЧАН: " СЕЙМЧАН "
  СЕЛИДОВО: " СЕЛИДОВЕ "
  СЕЛИЖАРОВО: " Селіжарово "
  ? "СЕЛО БАБУШКИНА"
  : " СЕЛО БАБУШКІНА "
  СЕЛТЫ: " СЕЛТ "
  СЕЛЬЦО: " Сельці "
  СЕМЕНОВ: " СЕМЕНОВ "
  СЕМЕНОВКА: " СЕМЕНІВКА "
  СЕМИКАРАКОРСК: " Семікаракорськ"
  СЕМИОЗЕРНОЕ: "СЕМІОЗЕРНОЕ "
  СЕМИПАЛАТИНСК: " Семипалатинськ "
  СЕНГИЛЕЙ: " СЕНГІЛЕЙ "
  СЕННО: " СЕННО "
  СЕРАФИМОВИЧ: " СЕРАФИМОВИЧ "
  СЕРГАЧ: " Сергач "
  СЕРГИЕВСК: " Сергієвський "
  СЕРДОБСК: " Сердобський "
  ? "СЕРЕБРЯН ПРУДЫ"
  : " Срібно СТАВКА "
  СЕРЕБРЯНСК: " СЕРЕБРЯНСЬКА "
  СЕРЕДИНА-БУДА: " СЕРЕДИНА-БУДА "
  СЕРМОНТОВО: " СЕРМОНТОВО "
  СЕРНУР: " СЕРНУР "
  СЕРОВ: " СЄРОВ "
  СЕРПУХОВ: " Серпухов "
  СЕРХОВОЖЬЕ: " СЕРХОВОЖЬЕ "
  СЕРЫШЕВО: " сєришево "
  СИВА: " Сива "
  СИВЕРСКАЯ: " Сіверська "
  СИГУЛДА: " Сигулда "
  СИДЕЛЬНИКОВО: " Сидельникова "
  СИЛЛАМЯЭ: " Сілламяе "
  СИМФЕРОПОЛЬ: " СІМФЕРОПОЛЬ "
  СИНЕГОРЬЕ: " Синьогора "
  СИНЕЛЬНИКОВО: " синельникове"
  СИСИАН: "СІСІАН "
  СКАДОВСК: " СКАДОВСЬК "
  СКВИРА: " СКВИРА "
  СКОВОРОДИНО: " сковородино "
  СКОЛЕ: " СКОЛЕ "
  СКОПИН: " Скопин "
  СКУОДАС: " СКУОДАС "
  СЛАВГОРОД: " Славгород "
  СЛАВСК: " СЛАВСЬКЕ "
  СЛАВУТА: " СЛАВУТА "
  СЛАВЯНКА: " СЛОВ&#39;ЯНКА "
  ? "СЛАВЯНКА ПРИМ."
  : " СЛОВ&#39;ЯНКА ПРИМ. "
  СЛАВЯНОГОРСК: " Слов&#39;яногірськ "
  СЛАВЯНОСЕРБСК: " СЛОВ&#39;ЯНОСЕРБСЬКИЙ "
  СЛАВЯНСК: " СЛОВ&#39;ЯНСЬК "
  ? "СЛАВЯНСК КБНЬ"
  : " СЛОВ&#39;ЯНСЬК КБНЬ "
  СЛАНЦЫ: " Сланци "
  СЛОБОДЗЕЯ: " Слободзея "
  СЛОБОДСКОЕ: " Слобідської "
  СЛОНИМ: " СЛОН "
  СЛУЦК: " Слуцьк "
  СМЕЛА: " СМІЛА "
  СМИДОВИЧИ: " Смідовича "
  СМИРНОВО: " СМИРНОВА "
  СМОЛЕВИЧИ: " Смолевичах"
  СМОЛЕНСК: "СМОЛЕНСЬК "
  СМОЛЕНСКОЕ: " СМОЛЕНСЬК "
  СМОРГОНЬ: " Сморгонь "
  СНЕЖНОЕ: " СНІЖНЕ "
  СНЕЧКУС: " СНЕЧКУС "
  СНИГИРЕВКА: " Снігурівка "
  СНЯТЫН: " снятин "
  СОБИНКА: " СОБІНКА "
  СОБОЛЕВО: " СОБОЛЄВА "
  СОВЕТАБАД: " СОВЕТАБАД "
  СОВЕТСК: " советские "
  ? "СОВЕТСК КИРОВ"
  : " советские КІРОВ "
  ? "СОВЕТСКАЯ ГАВАН"
  : " РАДЯНСЬКА ГАВАНА "
  СОВЕТСКИЙ: " РАДЯНСЬКИЙ "
  СОВЕТСКИЙ-БАРН: " РАДЯНСЬКИЙ-БАРНА "
  СОВЕТСКИЙ-ВБРГ: " РАДЯНСЬКИЙ-ВБРГ "
  СОВЕТСКИЙ-ДШНБ: " РАДЯНСЬКИЙ-ДШНБ "
  СОВЕТСКИЙ-НЛЬЧК: " РАДЯНСЬКИЙ-НЛЬЧК "
  СОВЕТСКИЙ-СИМФ: " РАДЯНСЬКИЙ-СИМФ "
  СОВЕТСКИЙ-ТЮМ: " РАДЯНСЬКИЙ-ТЮМ "
  СОВЕТСКОЕ: " РАДЯНСЬКЕ "
  ? "СОВХОЗ ИМ УШАЧИ"
  : " Радгосп ім УШАЧІ "
  СОКАЛЬ: " СОКАЛЬ "
  СОКИРЯНЫ: " Сокиряни "
  СОКОЛ: " СОКОЛ"
  СОКОЛИНСКОЕ: "Соколинський "
  СОКОЛОВКА: " Соколівка "
  СОКУЛУК: " СОКУЛУК "
  СОЛДАТСКИЙ: " Солдатський "
  СОЛЕНОЕ: " СОЛОНІ "
  СОЛИГАЛИЧ: " СОЛІГАЛІЧ "
  СОЛИГОРСК: " Солігорськ "
  СОЛИКАМСК: " Солікамському "
  СОЛНЕЧНЫЙ: " СОНЯЧНИЙ "
  СОЛНЦЕВО: " Солнцева "
  СОЛОТЧА: " СОЛОТЧА "
  СОЛТОН: " Солтона "
  СОЛЬ-ИЛЕЦК: " СІЛЬ-Ілецьк "
  СОЛЬЦЫ: " сольці "
  СОНКОВО: " СОНКОВО "
  СОРОКИ: " СОРОКИ "
  СОРОЧИНСК: " СОРОЧИНСЬКИЙ "
  СОРТАВАЛА: " Сортавала "
  СОСНИЦА: " СОСНИЦЯ "
  СОСНОВКА: " Соснівка "
  СОСНОВО: " соснове "
  СОСНОВО-ОЗЕРСК: " Сосново-Озерське "
  СОСНОВОБОРСК: " СОСНОВОБОРСК "
  ? "СОСНОВЫЙ БОР"
  : " Сосновий Бір "
  СОСНОГОРСК: " Сосногорськ"
  СОФИЕВКА: "СОФІЇВКА "
  СОЧИ: " СОЧІ "
  СПАС-ДЕМЕНСК: " СПАС-Деменськ "
  СПАС-КЛЕПИКИ: " СПАС-Клепіков "
  СПАССК-ДАЛЬНИЙ: " Спаськ-Дальній "
  СПАССК-РЯЗАНСКИ: " Спаськ-Рязанський "
  СПИРОВО: " Спірова "
  СПИТАК: " Спітак "
  СРЕБНОЕ: " Срібне "
  ? "СРЕДНЯЯ АХТУБА"
  : " СЕРЕДНЯ Ахтуба "
  СРЕТЕНСК: " Стрітенська "
  СТАВИЩЕ: " СТАВИЩЕ "
  СТАВРОПОЛЬ: " СТАВРОПОЛЬ "
  ? "СТАНИЦА АРХАНСК"
  : " Станиця АРХАНСК "
  СТАНИЧНО-ЛУГАНС: " СТАНИЧНО-ЛУГАНС "
  СТАНОВОЕ: " СТАВАЙ "
  ? "СТАРАЯ ВЫЖЕВКА"
  : " Стара Вижівка "
  ? "СТАРАЯ МАЙНА"
  : " СТАРА МАЙНА "
  ? "СТАРАЯ ПОЛТАВКА"
  : " СТАРА ПОЛТАВКА "
  ? "СТАРАЯ РУССА"
  : " СТАРА РУССА "
  ? "СТАРАЯ СИНЯВА"
  : " СТАРА СИНЯВА "
  СТАРИЦА: " Стариця "
  СТАРОАЛЕЙСКОЕ: " СТАРОАЛЕЙСКОЕ "
  СТАРОБЕЛЬСК: " СТАРОБЕЛЬСЬК"
  СТАРОБЕШЕВО: "Старобешеве "
  СТАРОДУБ: " СТАРОДУБ "
  ? "СТАРОЕ ШАЙГОВО"
  : " СТАРЕ ШАЙГОВО "
  СТАРОЖИЛОВО: " Старожилово "
  СТАРОКОНСТАНТИН: " Старокостянтинів "
  СТАРОМИНСКАЯ: " староминська "
  СТАРОЩЕРБИНОВСК: " СТАРОЩЕРБИНІВСЬКА "
  СТАРОЮРЬЕВО: " Староюр&#39;єво "
  ? "СТАРЫЕ ДОРОГИ"
  : " СТАРІ ДОРОГИ "
  ? "СТАРЫЙ ОСКОЛ"
  : " Старий Оскол "
  ? "СТАРЫЙ САМБОР"
  : " СТАРИЙ САМБІР "
  СТАХАНОВ: " СТАХАНОВ "
  СТЕПАНОВАН: " СТЕПАНОВАН "
  СТЕПАНОКЕРТ: " СТЕПАНОКЕРТ "
  СТЕПНОГОРСК: " Степногірськ "
  СТЕПНОЕ: " СТЕПНЕ "
  СТЕПНЯК: " СТЕПАНЯК "
  СТЕРЛИБАШЕВО: " СТЕРЛІБАШЕВО "
  СТЕРЛИТАМАК: " Стерлітамак "
  СТКУМЫЛЖЕНСКАЯ: " СТКУМИЛЖЕНСКАЯ "
  СТОЛБЦЫ: " Колонки "
  СТОЛИН: " Столін "
  СТОРОЖИНЕЦ: " СТОРОЖИНЕЦЬ "
  СТРАШЕНЫ: " Страшний "
  СТРЕЖЕВОЙ: " СТРЕЖЕВОЙ "
  СТРОЕНИЕ: " БУДОВА"
  СТРОИТЕЛЬ: "СТРОИТЕЛЬ "
  ? "СТРУГИ КРАСНЫЕ"
  : " Струга ЧЕРВОНІ "
  СТРЫЙ: " СТРИЙ "
  СТУПИНО: " Ступіно "
  СТУЧКА: " Стучка "
  СУВОРОВ: " СУВОРОВ "
  СУВОРОВО: " СУВОРОВА "
  СУДАК: " СУДАК "
  СУДЖА: " Суджа "
  СУДИСЛАВЛЬ: " СУДІСЛАВЛЬ "
  СУДОГДА: " СУДОГДА "
  СУЗАК: " СУЗАК "
  СУЗДАЛЬ: " Суздаль "
  СУЗЕМКА: " СУЗЕМКА "
  СУЗУН: " СУЗУН "
  СУКСУН: " СУКСУН "
  СУЛЮКТА: " Сулюкта "
  СУМГАИТ: " Сумгаїт "
  СУМЫ: " СУМИ "
  СУНА: " Суна "
  СУНТАР: " Сунтар "
  СУОЯРВИ: " Суоярви "
  СУРАЖ: " Сураж "
  СУРГУТ: " Сургут "
  СУРОВИКИНО: " суровикино"
  СУРСКОЕ: "Сурсько "
  СУСАНИНО: " Сусанин "
  СУСУМАН: " Сусуман "
  СУХИНИЧИ: " Сухиничи "
  СУХОБУЗИМСКОЕ: " СУХОБУЗІМСКОЕ "
  ? "СУХОЙ ЛОГ"
  : " СУХИЙ ЛОГ "
  СУХУМИ: " СУХУМІ "
  СЫЗРАНЬ: " Сизрань "
  СЫКТЫВКАР: " Сиктивкар "
  СЫРДАРЬЯ: " Сирдар&#39;ї "
  СЫСЕРТЬ: " СИСЕРТЬ "
  СЫЧЕВКА: " Сичовка "
  СЮМЕИ: " СЮМЕІ "
  СЯМЖА: " СЯМЖА "
  СЯСЬКЕЛОВО: " СЯСЬКЕЛОВО "
  Т-ЦКАРО: " Т-ЦКАРО "
  ТАБАГО: " ТАБАГО "
  ТАБУНЫ: " Табун "
  ТАВДА: " ТАВДА "
  ТАВРИЧЕСКОЕ: " ТАВРІЙСЬКИЙ "
  ? "ТАВРИЧЕСКОЕ ОМК"
  : " ТАВРІЙСЬКИЙ ОМК "
  ТАГАНРОГ: " Таганрог "
  ТАЗА-БАЗАР: " таза - БАЗАР "
  ТАЗОВСКИЙ: " Тазовський "
  ТАЙТУГ: " ТАЙТУГ"
  ТАЙШЕТ: "Тайшет "
  ТАЛАЛАЕВКА: " Талалаївка "
  ТАЛАС: " Талас "
  ТАЛГАР: " Талгар "
  ТАЛДОМ: " Талди "
  ТАЛДЫ-КУРГАН: " Талди-КУРГАН "
  ТАЛИН: " Талін "
  ТАЛИЦА: " Таліца "
  ТАЛЛИНН: " ТАЛЛІНН "
  ТАЛОВАЯ: " талова "
  ТАЛСИ: " Талсі "
  ТАЛШИК: " ТАЛШІК "
  ТАЛЬМЕНКА: " Тальменка "
  ТАЛЬНОЕ: " ТАЛЬНЕ "
  ТАМАЛА: " ТАМА "
  ТАМБОВ: " ТАМБОВ "
  ТАМДЫБУЛАК: " ТАМДИБУЛАК "
  ТАРА: " ТАРА "
  ТАРАКЛИЯ: " Тараклия "
  ТАРАНОВСКОЕ: " Тарановський "
  ТАРАША: " Тараш "
  ТАРБАГАТАЙ: " Тарбагатай "
  ТАРКО-САЛЕ: " Тарко-Сале "
  ТАРТУ: " ТАРТУ "
  ТАРУСА: " ТАРУС"
  ТАРУТИНО: "ТАРУТИНЕ "
  ТАСТЫ-ТАЛДЫ: " ТАСТ-Талди "
  ТАТАРБУНАРЫ: " ТАТАРБУНАРИ "
  ТАТАРСК: " ТАТАРСЬКА "
  ТАТИЩЕВО: " Татіщева "
  ТАУРАГЕ: " Таураге "
  ТАХИАТАШ: " ТАХІАТАШ "
  ТАХТА-БАЗАР: " Тахти-БАЗАР "
  ТАХТААБАД: " ТАХТААБАД "
  ТАХТАКУПЫР: " ТАХТАКУПИР "
  ТАШАУЗ: " ТАШАУЗ "
  ТАШБУЛАК: " ТАШБУЛАК "
  ТАШКЕНТ: " ТАШКЕНТ "
  ТАШЛАК: " ТАШЛАК "
  ТАШТАГОЛ: " ТАШТАГОЛ "
  ТБИЛИСИ: " ТБІЛІСІ "
  ТБИЛИССКАЯ: " Тбіліський "
  ТЕВРИЗ: " ТЕВРІЗ "
  ТЕДЖЕН: " Теджен "
  ТЕЙКОВО: " Тейково "
  ТЕКЕЛИ: " Текелі "
  ТЕЛАВИ: " Телаві "
  ТЕЛЕНЕШТЫ: " ТЕЛЕНЕШТИ "
  ТЕЛЬМАНОВО: " ТЕЛЬМАНОВЕ "
  ТЕЛЬМАНСК: " Тельманський"
  ТЕЛЬШЯЙ: "Тельше "
  ТЕМИРЛАНОВКА: " ТЕМІРЛАНОВКА "
  ТЕМИРТАУ: " Теміртау "
  ТЕМКИНО: " Тьомкін "
  ТЕМРЮК: " Темрюка "
  ТЕНЬГУШЕВО: " ТЕНЬГУШЕВО "
  ТЕОФИПОЛЬ: " Теофіполь "
  ТЕПЛИК: " ТЕПЛИК "
  ТЕПЛОЕ: " тепла "
  ТЕПЛОКЛЮЧЕНКА: " ТЕПЛОКЛЮЧЕНКА "
  ТЕРБУНЫ: " Тербуни "
  ТЕРЕБОВЛЯ: " ТЕРЕБОВЛЯ "
  ТЕРЕК: " Терек "
  ТЕРЕНЬГА: " ТЕРЕНЬГА "
  ТЕРМЕЗ: " Термез "
  ТЕРНЕЙ: " ТЕРНО "
  ТЕРНОВКА: " ТЕРНІВКА "
  ТЕРНОПОЛЬ: " ТЕРНОПІЛЬ "
  ТЕРСКОЛ: " Терскол "
  ТЕТИЕВ: " Тетіїв "
  ТЕТРИЦКАРО: " ТЕТРІЦКАРО "
  ТЕТЮШИ-ТАТАРС: " ТЕТЮШІ-ТАТАРС "
  ТИАНЕТИ: " ТІАНЕТІ "
  ТИГИЛЬ: " ТІГІЛЬ "
  ТИМАШЕВСК: " Тимашевськ"
  ТИМИРЯЗЕВО: "Тімірязєва "
  ТИРАСПОЛЬ: " ТИРАСПОЛЬ "
  ТИСУЛЬ: " ТІСУЛЬ "
  ТИХВИН: " Тихвин "
  ТИХОРЕЦК: " Тихорецьк "
  ТЛУМАЧ: " ТЛУМАЧ "
  ТОБОЛЬСК: " Тобольськ "
  ТОГУЛ: " ТОГУЛ "
  ТОГУЧИН: " Тогучин "
  ТОЙТЕПА: " ТОЙТЕПА "
  ТОКАРЕВКА: " Токарівка "
  ТОКАРИ: " ТОКАР "
  ? "ТОКМАК ЗАПОРОЖ"
  : " ТОКМАК Запоріжжі "
  ? "ТОКМАК ФРУНЗЕ"
  : " ТОКМАК ФРУНЗЕ "
  ТОКСОВО: " Токсово "
  ТОКТОГУЛ: " ТОКТОГУЛ "
  ТОЛБАЗЫ: " ТОЛБАЗИ "
  ТОЛОЧИН: " ТОЛОЧИНА "
  ТОЛЬЯТТИ: " Тольятті "
  ТОМАКОВКА: " Томаківка "
  ТОМАРИ: " Томари "
  ТОМАШПОЛЬ: " Томашпіль "
  ТОМСК: " ТОМСЬК "
  ТОПАР: " Топар "
  ТОПКИ: " ТОПку"
  ТОПЧИХА: "ТОПЧІХА "
  ТОРБЕЕВО: " Торбеево "
  ТОРЕЗ: " ТОРЕЗ "
  ТОРЖОК: " Торжок "
  ТОРОПЕЦ: " Торопець "
  ТОСНО: " ТОСНО "
  ТОТЬМА: " Тотьма "
  ТРАКАЙ: " Тракай "
  ТРОИЦК: " ТРОЇЦЬКИЙ "
  ТРОИЦКО-ПЕЧЕРСК: " ТРОЇЦЬКИЙ-ПЕЧЕРСЬКИЙ "
  ? "ТРОИЦКОЕ БАРНАУ"
  : " ТРОЇЦЬКИЙ БАРНАУ "
  ? "ТРОИЦКОЕ ВОРОШ"
  : " ТРОЇЦЬКИЙ Во "
  ? "ТРОИЦКОЕ ХАБАР"
  : " ТРОЇЦЬКИЙ ХАБАР "
  ТРОИЦКОЕ-КАЛМЫЦ: " Троїцько-КАЛМИЦ "
  ТРОСТЯНЕЦ: " ТРОСТЯНЕЦЬ "
  ? "ТРУБНИКОВ БОР"
  : " ТРУБНИКІВ БОР "
  ТРУБЧЕВСК: " Трубчевськ "
  ТРУСКАВЕЦ: " ТРУСКАВЕЦЬ "
  ТУАПСЕ: " ТУАПСЕ "
  ТУКУМС: " Тукумс "
  ТУЛА: " ТУЛА "
  ТУЛЬЧИН: " ТУЛЬЧИН "
  ТУРАКУРГАН: " ТУРАКУРГАН "
  ТУРИЙСК: " ТУРІЙСЬКИЙ "
  ТУРКА: " ТУРКА"
  ТУРКЕСТАН: "Туркестан "
  ТУРКИ: " ТУРКА "
  ТУРКМЕН-КАЛА: " Туркмен-Кала "
  ТУРСУНЗАДЕ: " Турсунзаде "
  ТУРТКУЛЬ: " ТУРТКУЛЬ "
  ТУРУНТАЕВО: " ТУРУНТАЕВО "
  ТУТАЕВ: " Тута "
  ТЫВРОВ: " Тиврів "
  ТЫНДА: " Тинда "
  ТЫРНЫАУЗ: " ТИРНИАУЗ "
  ТЫСМЕНИЦА: " Тисмениця "
  ТЮКАЛИНСК: " Тюкалинськ "
  ТЮМЕНЦЕВО: " ТЮМЕНЦЕВО "
  ТЮМЕНЬ: " ТЮМЕНЬ "
  ТЯЧЕВ: " ТЯЧІВ "
  УБИНСКОЕ: " УБІНСКОЕ "
  УВАРОВО: " УВАРОВА "
  УВАТ: " увати "
  УВЕЛЬСКИЙ: " УВЕЛЬСКІЙ "
  УГЛЕГОРСК: " Вуглегірськ "
  УГЛИЧ: " Углич "
  УГЛОВСКОЕ: " Угловського "
  УГРА: " угра "
  УДОМЛЯ: " УДОМЛЯ "
  УЖГОРОД: " УЖГОРОД"
  УЖУР: "Ужур "
  УЗГЕН: " УЗГЕН "
  УЗДА: " узда "
  УЗЛОВАЯ: " ВУЗЛОВА "
  УЗУН: " Узун "
  УЗУН-АГАЧ: " Узун-Агач "
  УИНСКОЕ: " УІНСКОЕ "
  УЙСКОЕ: " УЙСКОЕ "
  УЙЧИ: " УЙЧІ "
  УКМЕРГЕ: " УКМЕРГЕ "
  УЛАН-УДЭ: " УЛАН-УДЕ "
  УЛЕТЫ: " УЛЕТЫ "
  УЛЬЯНОВКА-КИРОВ: " УЛЬЯНОВКА-КІРОВ "
  УЛЬЯНОВКА-ТОСНО: " УЛЬЯНОВКА-ТОСНО "
  УЛЬЯНОВО: " УЛЬЯНОВА "
  УЛЬЯНОВСК: " УЛЬЯНІВСЬК "
  УЛЬЯНОВСК-КАРШИ: " УЛЬЯНІВСЬК-КАРШЕ "
  УЛЬЯНОВСКИЙ: " УЛЬЯНОВСЬКИЙ "
  УМАНЬ: " УМАНЬ "
  УМЕТ: " УМІТИ "
  УНГЕНЫ: " Унгени "
  УНЕЧА: " Унеча "
  УПОРОВО: " УПОРОВО "
  УРА-ТЮБЕ: " УРА-тюбе "
  УРАЙ: " Урай"
  УРАЛЬСК: "УРАЛЬСЬКОЇ "
  УРГЕНЧ: " Ургенч "
  УРГУТ: " УРГУТ "
  УРДЖАР: " УРДЖАР "
  УРЕНЬ: " Уренєв "
  УРЖУМ: " УРЖУМ "
  УРИЦКИЙ: " УРИЦЬКОГО "
  УРМАРЫ: " УРМАРИ "
  УРУС-МАРТАН: " Урус-Мартану "
  УРЮПИНСК: " Урюпінськ "
  УСАДИЩЕ: " УСАДІЩЕ "
  УСВЯТЫ: " Усвята "
  УСИНСК: " Усинську "
  УСМАНЬ: " Усмані "
  УСМАТ: " УСМАТ "
  УСОГОРСК: " УСОГОРСК "
  УСОЛЬЕ: " Усолля "
  УСОЛЬЕ-СИБИРСК: " усольє-сибирське "
  УСПЕНКА: " Успенка "
  УСПЕНСКОЕ: " УСПЕНСЬКИЙ "
  УССУРИЙСК: " Уссурійськ "
  УСТИНОВКА: " Устинівка "
  УСТЬ-БОЛЬШЕРЕЦК: " УСТЬ - Большерецького "
  УСТЬ-ДЖЕГУТА: " Усть-Джегута "
  УСТЬ-ДОНЕЦК: " УСТЬ-ДОНЕЦЬК"
  УСТЬ-ИЛИМСК: "Усть-Ілімськ "
  УСТЬ-ИШИМ: " УСТЬ-Ішим "
  УСТЬ-КАЛМАНКА: " УСТЬ-КЛИМЕНКО "
  УСТЬ-КАМЕНОГОР: " УСТЬ-КАМЕНОГОР "
  УСТЬ-КАМЧАТСК: " Усть-Камчатську "
  УСТЬ-КАТАВ: " усть-катав "
  УСТЬ-КИШЕРТЬ: " УСТЬ-КІШЕРТЬ "
  УСТЬ-КУБИНСКОЕ: " УСТЬ-Кубинський "
  УСТЬ-КУЛОМ: " Усть-Кулом "
  УСТЬ-КУТ: " УСТЬ-КУТ "
  УСТЬ-ЛАБИНСК: " Усть-Лабинськ "
  УСТЬ-ОМЧУГ: " Усть-Омчуг "
  УСТЬ-ОРДЫНСКИЙ: " УСТЬ - Ординський "
  УСТЬ-ТАРКА: " УСТЬ-ТарКо "
  УСТЬ-УДА: " УСТЬ-УДА "
  УСТЬ-ЦИЛЬМА: " Усть-Цильма "
  УСТЬ-ЧАРЫШСКАЯ: " УСТЬ-ЧАРИШСКАЯ "
  УСТЬЕ: " Устя "
  УСТЮЖНА: " УСТЮЖНА "
  УТЕНА: " Утена "
  УХОЛОВО: " Ухолово "
  УХТА: " Ухта "
  УЧАРАЛ: " УЧАРАЛ "
  УЧКИЗЫЛ: " УЧКІЗИЛ "
  УЧКУПРИК: " УЧКУПРІК"
  УЧКУРГАН: "УЧКУРГАН "
  УШАКИ: " УШАК "
  УШАЧИ: " УШАЧІ "
  УШТОБЕ: " УШТОБЕ "
  ФАЙЗАБАД: " Файзабад "
  ФАЛЕНКИ: " Філенко "
  ФАЛЕШТЫ: " ФАЛЕШТИ "
  ФАРАБ: " Фарабі "
  ФАРХОД: " ФАРХОД "
  ФАСТОВ: " ФАСТІВ "
  ФАТЕЖ: " Фатеж "
  ФЕДОРОВКА: " Федорівка "
  ФЕДОРОВСКОЕ: " Федоровський "
  ФЕОДОСИЯ: " ФЕОДОСІЯ "
  ФЕРГАНА: " Фергана "
  ФЕРЗИКОВО: " ФЕРЗІКОВО "
  ФЕРШАМПЕНАУЗ: " ФЕРШАМПЕНАУЗ "
  ФИРОВО: " Фиров "
  ФЛОРЕШТЫ: " Флорешть "
  ФОРНОСОВО: " ФОРНОСОВО "
  ФРОЛОВО: " ФРОЛОВА "
  ФРУНЗЕ: " ФРУНЗЕ "
  ФРУНЗЕНСКОЕ: " Фрунзенський "
  ФРУНЗОВКА: " Фрунзівка "
  ФУРМАНОВ: " ФУРМАНОВ"
  ФУРМАНОВКА: "Фурманівка "
  ФУРМАНОВО: " ФУРМАНОВА "
  ХААПСАЛУ: " Хаапсалу "
  ХАБАРОВСК: " ХАБАРОВСЬК "
  ХАБАРЫ: " ХАБАР "
  ХАВАЛИНГ: " ХАВАЛІНГ "
  ХАЗАРАСП: " ХАЗАРАСП "
  ХАККУЛАБАД: " ХАККУЛАБАД "
  ХАЛАЧ: " ХАЛАЧ "
  ХАНДЫГА: " ХАНДИГА "
  ХАНКА: " Ханке "
  ХАНТЫ-МАНСИЙСК: " Ханти-Мансійськ "
  ХАРАБАЛИ: " Харабали "
  ХАРОВСК: " Харовський "
  ХАРЦЫЗСК: " ХАРЦИЗСЬК "
  ХАРЬКОВ: " ХАРКІВ "
  ХАРЬЮС: " ХАРЬЮС "
  ХАТАСЫ: " ХАТАСИ "
  ХАХАРАСП: " ХАХАРАСП "
  ХАЧМАС: " хачмас "
  ХАШУРИ: " Хашурі "
  ХВАЛЫНСК: " Хвалинськ "
  ХВАСТОВИЧИ: " ХВАСТОВІЧІ "
  ХВОЙНАЯ: " Хвойні "
  ХЕРСОН: " ХЕРСОН"
  ХИВА: "Хіва "
  ХИЛОК: " хілок "
  ХИСЛАВИЧИ: " ХІСЛАВІЧІ "
  ХЛЕВНОЕ: " ХЛЕВНОЕ "
  ХМЕЛЬНИК: " ХМЕЛЬНИК "
  ХМЕЛЬНИЦКИЙ: " ХМЕЛЬНИЦЬКИЙ "
  ХОДЖААБАД: " ХОДЖААБАД "
  ХОДЖАМБАС: " ХОДЖАМБАС "
  ХОДЖЕЙЛИ: " ХОДЖЕЙЛІ "
  ХОЙНИКИ: " Хойниках "
  ХОЛМ-ЖИРКОВСКИЙ: " ПАГОРБ-ЖІРКОВСКІЙ "
  ХОЛМСК: " Холмськ "
  ХОМУТОВКА: " ХОМУТОВКА "
  ХОМУТОВО: " Хомутова "
  ХОРИНСК: " Хорінськ "
  ХОРОЛ: " ХОРОЛ "
  ХОРОЛЬ: " ХОРОЛ "
  ХОТИМСК: " Хотимський "
  ХОТИН: " ХОТИН "
  ХОТЫНЕЦ: " ХОТИНЕЦ "
  ХОХОЛЬСКИЙ: " ХОХОЛЬСКІЙ "
  ХРАБРАВО: " ХРАБРАВО "
  ХРИСТИНОВКА: " ХРИСТИНІВКА "
  ХРОМТАУ: " ХРОМТАУ "
  ХУНЗАХ: " Хунза"
  ХУСТ: "ХУСТ "
  ЦАЛКА: " Цалко "
  ЦАРИЧАНКА: " ЦАРИЧАНКА "
  ЦАХКАОВИТ: " ЦАХКАОВІТ "
  ЦВЕЛОДУБОВО: " ЦВЕЛОДУБОВО "
  ЦЕЛИНА: " Цілина "
  ЦЕЛИННОЕ: " Целинная "
  ЦЕЛИННОС: " ЦЕЛІННОС "
  ЦЕЛИНОГРАД: " Целіноград "
  ЦЕЛИНСКОЕ: " Целінський "
  ЦЕСИС: " Цесисе "
  ЦИВИЛЬСК: " Цивільський "
  ЦУМАНЬ: " ЦУМАНЬ "
  ЦХАЛТУБА: " Цхалтубо "
  ЦХИНВАЛИ: " ВІЛАЙЯТ ДАГЕСТАН "
  ЦЮРУПИНСК: " ЦЮРУПИНСЬКИЙ "
  ЧАГОДА: " ЧАГОДА "
  ЧАДЫР-ЛУНГА: " Чадир-Лунга "
  ЧАЕК: " чайок "
  ЧАЙКОВСКИЙ: " ЧАЙКОВСЬКИЙ "
  ЧАЛТЫРЬ: " ЧАЛТИРЬ "
  ЧАМЗИНКА: " чамзинка "
  ЧАНЫ: " чани "
  ЧАПАЕВ: " ЧАПАЕВ "
  ЧАПАЕВСК: " Чапаєвськ"
  ЧАПЛЫГИН: "Чаплигін "
  ЧАПЛЫНКА: " Чаплинка "
  ЧАРА: " Чара "
  ЧАРДЖОУ: " Чарджоу "
  ЧАРЕНЦАВАН: " ЧАРЕНЦАВАН "
  ЧАРСК: " Чарський "
  ЧАРТАП: " ЧАРТАП "
  ЧАРШАНГА: " ЧАРШАНГА "
  ЧАРЫШСКОЕ: " ЧАРИШСКОЕ "
  ЧАСОВОНСКОЕ: " ЧАСОВОНСКОЕ "
  ЧАСТООЗЕРЬЕ: " ЧАСТООЗЕРЬЕ "
  ЧАСТЫЕ: " ЧАСТІ "
  ЧАТКАЛ: " Чаткал "
  ЧАУСЫ: " Чаус "
  ЧАШНИКИ: " Чашник "
  ЧЕБАКУЛЬ: " ЧЕБАКУЛЬ "
  ЧЕБОКСАРЫ: " Чебоксари "
  ЧЕГДОМЫН: " ЧЕГДОМИН "
  ЧЕГЕМ: " Чегема "
  ЧЕКМАГУШ: " ЧЕКМАГУШ "
  ЧЕЛКАР: " ЧЕЛКАР "
  ЧЕЛНО-ВЕРШИНЫ: " Челни-Вершини "
  ЧЕЛЯБИНСК: " ЧЕЛЯБІНСЬК "
  ЧЕМЕРОВЦЫ: " ЧЕМЕРІВЦІ "
  ЧЕРВЕНЬ: " ЧЕРВЕНЬ"
  ЧЕРВОНОАРМЕЙСК: "ЧЕРВОНОАРМІЙСЬКИЙ "
  ЧЕРВОНОГРАД: " ЧЕРВОНОГРАД "
  ЧЕРДАКЛЫ: " Чердакли "
  ЧЕРЕМИСИНОВО: " черемисиново "
  ЧЕРЕМХОВО: " черемхово "
  ЧЕРЕМШАН: " Черемшина "
  ЧЕРЕПАНОВО: " Черепанова "
  ЧЕРЕПОВЕЦ: " ЧЕРЕПОВЕЦЬ "
  ЧЕРИКОВ: " Чериков "
  ЧЕРКАСОВО: " ЧЕРКАСОВА "
  ЧЕРКАССЫ: " ЧЕРКАСИ "
  ЧЕРКЕССК: " Черкеськ "
  ЧЕРЛАК: " ЧЕРЛАК "
  ЧЕРНИГОВ: " ЧЕРНІГІВ "
  ЧЕРНИГОВКА: " Чернігівка "
  ЧЕРНОБАЙ: " ЧЕРНОБАЙ "
  ЧЕРНОБЫЛЬ: " ЧОРНОБИЛЬ "
  ЧЕРНОВЦЫ: " ЧЕРНІВЦІ "
  ЧЕРНОГОРСК: " Чорногорський "
  ЧЕРНОМОРСКОЕ: " ЧОРНОМОРСЬКЕ "
  ЧЕРНУХИ: " ЧЕРНУХИ "
  ЧЕРНУШКА: " Чернушка "
  ? "ЧЕРНЫЙ ЯР"
  : " ЧОРНИЙ ЯР "
  ЧЕРНЫШЕВСК: " ЧЕРНИШЕВСЬКОГО "
  ЧЕРНЫШКОВСКИЙ: " ЧЕРНИШКОВСКІЙ"
  ЧЕРНЬ: "ЧОРНО "
  ЧЕРНЯНКА: " Чернянка "
  ЧЕРНЯХОВ: " Черняхів "
  ЧЕРНЯХОВСК: " ЧЕРНЯХОВСЬКИЙ "
  ЧЕРТКОВО: " Чорткова "
  ЧЕСМА: " Чесма "
  ЧЕХОВ: " ЧЕХОВ "
  ЧЕЧЕЛЬНИК: " ЧЕЧЕЛЬНИК "
  ЧЕЧЕРСК: " Чечерськ "
  ЧИГИРИН: " ЧИГИРИН "
  ЧИКОЛА: " Чіколе "
  ЧИЛИК: " ЧІЛІК "
  ЧИМБАЙ: " ЧІМБАЙ "
  ЧИМИШЛИЯ: " ЧІМІШЛІЯ "
  ЧИМКЕНТ: " Чимкент "
  ЧИНАЗ: " ЧІНАЗ "
  ЧИРАКЧИ: " Чіракчі "
  ЧИРЧИК: " Чирчик "
  ЧИСТООЗЕРНОЕ: " ЧІСТООЗЕРНОЕ "
  ЧИСТОПОЛЬ: " Чистополя "
  ЧИСТОПОЛЬЕ: " Чистополя "
  ЧИТА: " ЧИТА "
  ЧИШМЫ: " чишми "
  ЧКАЛОВО: " ЧКАЛОВА "
  ЧКАЛОВСК: " Чкаловськ"
  ЧОЛПАН-АТА: "ЧОЛПАН-АТА "
  ЧОРТКОВ: " ЧОРТКІВ "
  ЧУГУЕВ: " ЧУГУЇВ "
  ЧУГУЕВКА: " Чугуївка "
  ЧУДНОВ: " чуднів "
  ЧУДОВО: " ЧУДОВО "
  ? "ЧУДСКОЙ БОР"
  : " Чудському БОР "
  ЧУЛЫМ: " Чулимі "
  ЧУНДЖА: " ЧОНЧЖУ "
  ЧУНСКИЙ: " ЧУНСКІЙ "
  ЧУРАПЧА: " Чурапча "
  ЧУСОВОЙ: " юХУПЧПК "
  ЧУСТ: " ЧУСТ "
  ЧУТОВО: " ЧУТОВО "
  ЧУХЛОМА: " ЧУХЛОМА "
  ЧУЧКОВО: " Чучкова "
  ШАБЛЫКИНО: " ШАБЛИКІНО "
  ШАВАТ: " ШАВАТ "
  ШАДРИНСК: " Шадринськ "
  ШАКЯЙ: " ШАКЯЙ "
  ШАЛИ: " шалі "
  ШАЛИНСКОЕ: " Шалінському "
  ШАЛЬЧИНИНКАЙ: " ШАЛЬЧІНІНКАЙ "
  ШАПКИ: " ШАПКИ "
  ШАРАН: " ШАРА"
  ШАРГОРОД: "ШАРГОРОД "
  ШАРКАН: " човгав "
  ШАРКОВЩИНА: " ШАРКОВЩІНА "
  ШАРЛЫК: " ШАРЛИК "
  ШАРЫПОВО: " Шарипово "
  ШАРЬЯ: " Шар&#39;я "
  ШАТРОВО: " Шатрова "
  ШАТУРА: " Шатура "
  ШАФИРКАН: " ШАФІРКАН "
  ШАХОВСКАЯ: " Шаховской "
  ШАХРИХАН: " ШАХРІХАН "
  ШАХРНСАБЗ: " ШАХРНСАБЗ "
  ШАХТЕРСК: " ШАХТАРСЬКА "
  ШАХТИНСК: " Шахтинський "
  ШАХТЫ: " ШАХТИ "
  ШВЕНЧЕНИС: " ШВЕНЧЕНІС "
  ШЕБАЛИНО: " Шебаліна "
  ШЕВЧЕНКО: " ШЕВЧЕНКО "
  ШЕВЧЕНКОВО: " ШЕВЧЕНКОВЕ "
  ШЕКИ: " Шекі "
  ШЕКСНА: " Шексна "
  ШЕЛАБОЛИХА: " ШЕЛАБОЛІХА "
  ШЕЛЕХОВ: " Шелехов "
  ШЕЛКОВСКАЯ: " Шелковський "
  ШЕЛОПУГИНО: " ШЕЛОПУГІНО"
  ШЕМАХА: "Шемаха "
  ШЕМОНАИХА: " ШЕМОНАІХА "
  ШЕМУРША: " ШЕМУРША "
  ШЕМЫШЕЙКА: " ШЕМИШЕЙКА "
  ШЕНТАЛА: " ШЕНТАЛА "
  ШЕПЕТОВКА: " ШЕПЕТІВКА "
  ШЕРАБАТ: " ШЕРАБАТ "
  ШИГОНЫ: " ШІГОНИ "
  ШИЛАЛЕ: " Шилале "
  ШИЛКА: " Шилко "
  ШИЛОВО: " ШИЛОВА "
  ШИЛУТЕ: " ШІЛУТЕ "
  ШИМАНОВСК: " Шимановськ "
  ШИМСК: " ШІМСК "
  ШИПУНОВО: " Шипунова "
  ШИРВИНТОС: " ШІРВІНТОС "
  ШИРИН: " Ширина "
  ШИРОКОЕ: " ШИРОКЕ "
  ШИРЯЕВО: " Ширяєве "
  ШИШАКИ: " Шишаки "
  ШКЛОВ: " Шклов "
  ШОЛДАНЕШТЫ: " ШОЛДАНЕШТИ "
  ШОРТАНДЫ: " ШОРТАНДИ "
  ШОСТКА: " ШОСТКА "
  ШПАКОВСКОЕ: " Шпаковський"
  ШПОЛА: "ШПОЛА "
  ШУЙСКОЕ: " ШУЙСЬКИЙ "
  ШУЛИХА: " ШУЛІХА "
  ШУМЕРЛЯ: " Шумерля "
  ШУМИЛИНО: " Шуміліна "
  ШУМИХА: " Галас "
  ШУМСКОЕ: " ШУМСЬКИЙ "
  ШУМЯЧИ: " ШУМЯЧІ "
  ШУРЧИ: " ШУРЧІ "
  ШУША: " Шуша "
  ШУШЕНСКОЕ: " Шушенська "
  ШЯУЛЯЙ: " ШЯУЛЯЙ "
  ЩЕБЕКИНО: " ЩЕБЕКІНО "
  ЩЕГЛОВ: " Щеглов "
  ЩЕКИНО: " ЩОКІН "
  ЩЕЛКОВО: " Щелкова "
  ЩЕРБАКТЫ: " ЩЕРБАКТИ "
  ЩЕРБАКУЛЬ: " ЩЕРБАКУЛЬ "
  ЩИГРЫ: " Щигри "
  ЩОРС: " ЩОРС "
  ЩУЧИН: " Щучин "
  ЩУЧИНСК: " Щучинськ "
  ЫТЫК-КЮЕЛЬ: " ИТИК-КЮЕЛЬ "
  ЭКИБАСТУЗ: " Екібастуз "
  ЭЛЕКТРЕНАЙ: " ЭЛЕКТРЕНАЙ"
  ЭЛЕКТРОСТАЛЬ: "Електросталь "
  ЭЛИСТА: " Еліста "
  ЭЛЬХОТОВО: " Ельхотово "
  ЭНГЕЛЬС: " ЕНГЕЛЬСА "
  ЭНЕРГЕТИЧЕСКИЙ: " ЕНЕРГЕТИЧНИЙ "
  ЭНЕРГОДАР: " ЕНЕРГОДАР "
  ЭРТИЛЬ: " ЕРТІЛЬ "
  ЭССО: " ЕССО "
  ЭЧМИАДЗИН: " Ечміадзін "
  ЮЖНО-САХАЛИНСК: " Южно-Сахалінськ "
  ЮЖНОУКРАИНСК: " ЮЖНОУКРАЇНСЬК "
  ЮЖНОУРАЛЬСК: " Южноуральська "
  ЮКАМЕНСКОЕ: " ЮКАМЕНСКОЕ "
  ЮНОКОММУНАРСК: " ЮНОКОММУНАРСК "
  ЮРБАРКАС: " Юрбаркас "
  ЮРГА: " Юрга "
  ЮРГАМЫШ: " Юргамиш "
  ЮРИНО: " Юрін "
  ? "ЮРЬЕВ ПОЛЬСКИЙ"
  : " ЮР&#39;ЄВА ПОЛЬСЬКА "
  ЮРЬЕВЕЦ: " Юр&#39;євець "
  ЮРЬЯ: " ЮРЬЯ "
  ЮХНОВ: " Юхнов "
  ЯВЛЕНКА: " ЯВЛЕНКА "
  ЯВОРОВ: " ЯВІР "
  ЯГОДНОЕ: " ЯГІДНОГО"
  ЯГОТИН: "ЯГОТИН "
  ЯДРИН: " ЯДЕРНОЇ "
  ЯЗЫКОВО: " Мовні "
  ЯЗЬЯВАН: " ЯЗЬЯВАН "
  ЯЙПАН: " ЯЙПАН "
  ЯККАБАГ: " ЯККАБАГ "
  ЯКОВЛЕВКА: " Яковлівка "
  ЯКУТСК: " ЯКУТСЬКА "
  ? "ЯКШУР БОДЬЯ"
  : " ЯКШУР БОДЬЯ "
  ЯКШУР-БОДЬЯ: " ЯКШУР-БОДЬЯ "
  ЯЛТА: " ЯЛТА "
  ЯЛУТОРОВСК: " Ялуторовськ "
  ЯМПАЛЬ: " ЯМПАЛЬ "
  ЯМПОЛЬ: " ЯМПОЛЬ "
  ЯНАВАН: " ЯНАВАН "
  ЯНАУЛ: " янаул "
  ЯНГИ-МИРИШКОР: " Янги-МІРІШКОР "
  ЯНГИ-НИШАН: " Янги-Ніша "
  ЯНГИАБАД: " ЯНГІАБАД "
  ЯНГИАРЫК: " ЯНГІАРИК "
  ЯНГИАУЛ: " ЯНГІАУЛ "
  ЯНГИБАЗАР-БУХАР: " ЯНГІБАЗАР -Бухарі "
  ЯНГИБАЗАР-ТАШК.: " ЯНГІБАЗАР-Ташков. "
  ЯНГИБАЗАР-УРГЕН: " ЯНГІБАЗАР-УРГЕН "
  ЯНГИЕР: " ЯНГІЕР"
  ЯНГИКУРГАН: "ЯНГІКУРГАН "
  ? "ЯНГИКУРГАН НАМ"
  : "ЯНГІКУРГАН НАМ "
  ЯНГИЮЛЬ-ТАШКЕНТ: " ЯНГІЮЛЬ-ТАШКЕНТ "
  ЯНГИЮЛЬ-ТЕРМЕЗ: " ЯНГІЮЛЬ-Термез "
  ЯНИНО: " ЙОАНІНА "
  ЯНТАРНОЕ: " ЯНТАРНИЙ "
  ЯНТИКОВО: " ЯНТІКОВО "
  ЯНШИКИШЛАК: " ЯНШІКІШЛАК "
  ЯРАНСК: " Яранському "
  ЯРЕМЧА: " ЯРЕМЧА "
  ЯРКОВО: " Яркова "
  ЯРМОЛИЦЫ: " ЯРМОЛІЦИ "
  ЯРОСЛАВЛЬ: " ЯРОСЛАВЛЬ "
  ЯРЦЕВО: " Ярцева "
  ЯСИНОВАТАЯ: " ЯСИНУВАТА "
  ЯСИНОГОРСК: " ЯСІНОГОРСК "
  ЯСНОГОРСК: " Ясногорська "
  ЯШИНО: " ЯШИНА "
  ЯШКИНО: " Яшкін "
